SERVICIO;ESPECIALIDADES;ING;PASES_A;ING_PASES;ALTAS;DEF;TOTAL;PASES_B;EGR_PASES;DIAS_CAMAS_DISP;PAC_DIA;PROMEDIO_CAMAS_DISP;PROMEDIO_PAC_DIA;PORCENTAJE_OCUP;PROMEDIO_PERM;GIRO;TASA_MORT_HOSP;ANIO;SK_ID_EFECTOR;NOM_EFECTOR_BADATA;OBSERVACIONES
Cirugia;Urologia;304;21;325;319;0;319;4;323;4714;1820;1292;499;3861;563;2501;0;2011;2164;HOSPITAL GENERAL DE NIÑOS RICARDO GUTIERREZ;
Cirugia;Subtotal Cirugia;4661;634;5295;4616;27;4643;646;5289;48525;26327;13295;7213;5425;498;3978;51;2011;2164;HOSPITAL GENERAL DE NIÑOS RICARDO GUTIERREZ;
Urgencia;Terapia Intensiva;101;236;337;3;62;65;273;338;6089;5102;1668;1398;8379;1509;2026;1834;2011;2164;HOSPITAL GENERAL DE NIÑOS RICARDO GUTIERREZ;
Urgencia;Subtotal Urgencia;101;236;337;3;62;65;273;338;6089;5102;1668;1398;8379;1509;2026;1834;2011;2164;HOSPITAL GENERAL DE NIÑOS RICARDO GUTIERREZ;
Urgencia;Total Hospital;9749;1592;11341;9633;124;9757;1592;11349;116113;79283;31812;21721;6828;813;3067;127;2011;2164;HOSPITAL GENERAL DE NIÑOS RICARDO GUTIERREZ;
Pediatria;Recien Nacido Sano;5238;602;5840;5397;0;5397;446;5843;25141;16515;6888;4525;6569;283;8483;0;2011;2167;HOSPITAL MATERNO INFANTIL R. SARDA;
Pediatria;Neonatología;1298;1010;2308;1084;69;1153;1168;2321;29558;14639;8098;4011;4953;631;2866;297;2011;2167;HOSPITAL MATERNO INFANTIL R. SARDA;
Pediatria;Subtotal Pediatria;6536;1612;8148;6481;69;6550;1614;8164;54699;31154;14986;8535;5696;382;5448;85;2011;2167;HOSPITAL MATERNO INFANTIL R. SARDA;
Tocoginecologia;Tocoginecología;8015;214;8229;8064;0;8064;152;8216;37916;31831;10388;8721;8395;387;7909;0;2011;2167;HOSPITAL MATERNO INFANTIL R. SARDA;
Tocoginecologia;Subtotal Tocoginecologia;8015;214;8229;8064;0;8064;152;8216;37916;31831;10388;8721;8395;387;7909;0;2011;2167;HOSPITAL MATERNO INFANTIL R. SARDA;
Urgencia;Terapia Intermedia;57;33;90;57;0;57;32;89;1095;314;3;86;2868;353;2967;0;2011;2167;HOSPITAL MATERNO INFANTIL R. SARDA;
Urgencia;Terapia Intensiva;68;17;85;4;4;8;78;86;1460;349;4;96;239;406;215;465;2011;2167;HOSPITAL MATERNO INFANTIL R. SARDA;
Urgencia;Subtotal Urgencia;125;50;175;61;4;65;110;175;2555;663;7;182;2595;379;25;229;2011;2167;HOSPITAL MATERNO INFANTIL R. SARDA;
Urgencia;Total Hospital;14676;1876;16552;14606;73;14679;1876;16555;95170;63648;26074;17438;6688;434;563;5;2011;2167;HOSPITAL MATERNO INFANTIL R. SARDA;
Medicina;Dermatología;358;23;381;333;2;335;42;377;10966;6477;3004;1775;5906;1718;1255;53;2011;2110;HOSPITAL DE INFECCIOSAS F. MUÑIZ;
Medicina;Infecciosas;1442;312;1754;1377;106;1483;281;1764;39738;28273;10887;7746;7115;1603;162;601;2011;2110;HOSPITAL DE INFECCIOSAS F. MUÑIZ;
Medicina;Hepatopatía;309;21;330;292;13;305;25;330;4731;2192;1296;601;4633;664;2546;394;2011;2110;HOSPITAL DE INFECCIOSAS F. MUÑIZ;
Medicina;Neumotisiología;557;65;622;550;7;557;62;619;25681;20696;7036;567;8059;3343;88;113;2011;2110;HOSPITAL DE INFECCIOSAS F. MUÑIZ;
Medicina;Asistencia Respiratoria Intermedia;243;307;550;101;86;187;361;548;5164;3168;1415;868;6135;578;3873;1569;2011;2110;HOSPITAL DE INFECCIOSAS F. MUÑIZ;
Medicina;Zoopatología Médica;284;80;364;289;11;300;60;360;6165;3327;1689;912;5397;924;2131;306;2011;2110;HOSPITAL DE INFECCIOSAS F. MUÑIZ;
Medicina;Subtotal Medicina;3193;808;4001;2942;225;3167;831;3998;92445;64133;25327;17571;6937;1604;1579;563;2011;2110;HOSPITAL DE INFECCIOSAS F. MUÑIZ;
Cirugia;Cirugía General;512;75;587;522;5;527;56;583;7244;2697;1985;739;3723;463;2938;86;2011;2110;HOSPITAL DE INFECCIOSAS F. MUÑIZ;
Cirugia;Subtotal Cirugia;512;75;587;522;5;527;56;583;7244;2697;1985;739;3723;463;2938;86;2011;2110;HOSPITAL DE INFECCIOSAS F. MUÑIZ;
Pediatria;Infecciosas Pediatría;608;8;616;610;0;610;5;615;10794;6149;2957;1685;5697;10;208;0;2011;2110;HOSPITAL DE INFECCIOSAS F. MUÑIZ;
Pediatria;Subtotal Pediatria;608;8;616;610;0;610;5;615;10794;6149;2957;1685;5697;10;208;0;2011;2110;HOSPITAL DE INFECCIOSAS F. MUÑIZ;
Urgencia;Terapia Intensiva;121;179;300;28;94;122;178;300;2720;1809;745;496;6651;603;4026;3133;2011;2110;HOSPITAL DE INFECCIOSAS F. MUÑIZ;
Urgencia;Subtotal Urgencia;121;179;300;28;94;122;178;300;2720;1809;745;496;6651;603;4026;3133;2011;2110;HOSPITAL DE INFECCIOSAS F. MUÑIZ;
Urgencia;Total Hospital;4434;1070;5504;4102;324;4426;1070;5496;113203;74788;31015;2049;6607;169;1427;732;2011;2110;HOSPITAL DE INFECCIOSAS F. MUÑIZ;
Medicina;Curieterapia;97;2;99;98;0;98;1;99;1024;359;281;98;3506;363;3529;0;2011;2168;HOSPITAL MUNICIPAL DE ONCOLOGIA MARIE CURIE;
Medicina;Medicina;1697;21;1718;1230;439;1669;49;1718;20960;18495;5742;5067;8824;1077;2992;2555;2011;2168;HOSPITAL MUNICIPAL DE ONCOLOGIA MARIE CURIE;
Medicina;Subtotal Medicina;1794;23;1817;1328;439;1767;50;1817;21984;18854;6023;5165;8576;1038;3017;2416;2011;2168;HOSPITAL MUNICIPAL DE ONCOLOGIA MARIE CURIE;
Cirugia;Cirugía General;736;47;783;750;16;766;20;786;9005;3812;2467;1044;4233;485;3186;204;2011;2168;HOSPITAL MUNICIPAL DE ONCOLOGIA MARIE CURIE;
Cirugia;Subtotal Cirugia;736;47;783;750;16;766;20;786;9005;3812;2467;1044;4233;485;3186;204;2011;2168;HOSPITAL MUNICIPAL DE ONCOLOGIA MARIE CURIE;
Cirugia;Total Hospital;2530;70;2600;2078;455;2533;70;2603;30989;22666;849;621;7314;895;2983;1796;2011;2168;HOSPITAL MUNICIPAL DE ONCOLOGIA MARIE CURIE;
Cirugia;Cirugía Plástica;593;3;596;591;0;591;5;596;3285;711;9;195;2164;119;6622;0;2011;2112;HOSPITAL DE QUEMADOS DR. ARTURO UMBERTO ILLIA;
Cirugia;Quemados ;10;149;159;87;2;89;68;157;3861;3583;1058;982;928;2282;1484;127;2011;2112;HOSPITAL DE QUEMADOS DR. ARTURO UMBERTO ILLIA;
Cirugia;Quemados - Cuidados Generales - Adultos;58;206;264;231;1;232;35;267;5577;3326;1528;911;5964;1246;1747;37;2011;2112;HOSPITAL DE QUEMADOS DR. ARTURO UMBERTO ILLIA;
Cirugia;Subtotal Cirugia;661;358;1019;909;3;912;108;1020;12723;7620;3486;2088;5989;747;2926;29;2011;2112;HOSPITAL DE QUEMADOS DR. ARTURO UMBERTO ILLIA;
Pediatria;Quemados ;58;248;306;157;0;157;150;307;5010;3445;1373;944;6876;1122;2237;0;2011;2112;HOSPITAL DE QUEMADOS DR. ARTURO UMBERTO ILLIA;
Pediatria;Quemados - Cuidados Generales - Pediatría;18;154;172;157;0;157;16;173;2790;1218;764;334;4366;704;2263;0;2011;2112;HOSPITAL DE QUEMADOS DR. ARTURO UMBERTO ILLIA;
Pediatria;Subtotal Pediatria;76;402;478;314;0;314;166;480;7800;4663;2137;1278;5978;971;2246;0;2011;2112;HOSPITAL DE QUEMADOS DR. ARTURO UMBERTO ILLIA;
Urgencia;Guardia;580;0;580;70;2;72;508;580;1095;175;3;48;1598;3;19333;34;2011;2112;HOSPITAL DE QUEMADOS DR. ARTURO UMBERTO ILLIA;
Urgencia;Quemados Cuidados Intensivos - Adultos;5;90;95;1;30;31;65;96;2068;1856;567;508;8975;1933;1694;3125;2011;2112;HOSPITAL DE QUEMADOS DR. ARTURO UMBERTO ILLIA;
Urgencia;Subtotal Urgencia;585;90;675;71;32;103;573;676;3163;2031;867;556;6421;3;7801;473;2011;2112;HOSPITAL DE QUEMADOS DR. ARTURO UMBERTO ILLIA;
Internacion De Corta Estadia;Cirugia De Corta Estadia;61;0;61;58;0;58;3;61;1825;60;5;16;329;98;122;0;2011;2112;HOSPITAL DE QUEMADOS DR. ARTURO UMBERTO ILLIA;
Internacion De Corta Estadia;Subtotal Internacion De Corta Estadia;61;0;61;58;0;58;3;61;1825;60;5;16;329;98;122;0;2011;2112;HOSPITAL DE QUEMADOS DR. ARTURO UMBERTO ILLIA;
Internacion De Corta Estadia;Total Hospital;1383;850;2233;1352;35;1387;850;2237;25511;14374;6989;3938;5634;1036;1984;252;2011;2112;HOSPITAL DE QUEMADOS DR. ARTURO UMBERTO ILLIA;
Medicina;Hepatología;162;19;181;108;14;122;56;178;2311;2110;633;578;913;1185;2811;787;2011;2109;HOSPITAL DE GASTROENTEROLOGIA B. UDAONDO;
Medicina;Clínica Médica;941;91;1032;713;57;770;267;1037;12778;10466;3501;2867;8191;1009;2962;55;2011;2109;HOSPITAL DE GASTROENTEROLOGIA B. UDAONDO;
Medicina;Subtotal Medicina;1103;110;1213;821;71;892;323;1215;15089;12576;4134;3445;8335;1035;2939;584;2011;2109;HOSPITAL DE GASTROENTEROLOGIA B. UDAONDO;
Cirugia;Cirugía;1129;381;1510;1367;1;1368;133;1501;10350;7423;2836;2034;7172;495;5293;7;2011;2109;HOSPITAL DE GASTROENTEROLOGIA B. UDAONDO;
Cirugia;Subtotal Cirugia;1129;381;1510;1367;1;1368;133;1501;10350;7423;2836;2034;7172;495;5293;7;2011;2109;HOSPITAL DE GASTROENTEROLOGIA B. UDAONDO;
Urgencia;Terapia Intensiva;98;177;275;9;51;60;212;272;2508;1411;687;387;5626;519;3959;1875;2011;2109;HOSPITAL DE GASTROENTEROLOGIA B. UDAONDO;
Urgencia;Subtotal Urgencia;98;177;275;9;51;60;212;272;2508;1411;687;387;5626;519;3959;1875;2011;2109;HOSPITAL DE GASTROENTEROLOGIA B. UDAONDO;
Urgencia;Total Hospital;2330;668;2998;2197;123;2320;668;2988;27947;21410;7657;5866;7661;923;303;53;2011;2109;HOSPITAL DE GASTROENTEROLOGIA B. UDAONDO;
Cirugia;Oftalmología;3348;0;3348;3345;0;3345;0;3345;14600;3950;40;1082;2705;118;8363;0;2011;2169;HOSPITAL OFTALMOLOGICO DR. PEDRO LAGLEYZE;
Cirugia;Subtotal Cirugia;3348;0;3348;3345;0;3345;0;3345;14600;3950;40;1082;2705;118;8363;0;2011;2169;HOSPITAL OFTALMOLOGICO DR. PEDRO LAGLEYZE;
Cirugia;Total Hospital;3348;0;3348;3345;0;3345;0;3345;14600;3950;40;1082;2705;118;8363;0;2011;2169;HOSPITAL OFTALMOLOGICO DR. PEDRO LAGLEYZE;
Cirugia;Neurocirugía;42;34;76;43;0;43;31;74;6590;534;1805;146;81;722;41;0;2011;2111;HOSPITAL DE OFTALMOLOGIA SANTA LUCIA;
Cirugia;Oftalmología;4110;0;4110;4097;0;4097;1;4098;11263;3103;3086;85;2755;76;1328;0;2011;2111;HOSPITAL DE OFTALMOLOGIA SANTA LUCIA;
Cirugia;Subtotal Cirugia;4152;34;4186;4140;0;4140;32;4172;17853;3637;4891;996;2037;87;853;0;2011;2111;HOSPITAL DE OFTALMOLOGIA SANTA LUCIA;
Urgencia;Terapia Intensiva;5;31;36;3;0;3;33;36;1095;127;3;35;116;353;12;0;2011;2111;HOSPITAL DE OFTALMOLOGIA SANTA LUCIA;
Urgencia;Subtotal Urgencia;5;31;36;3;0;3;33;36;1095;127;3;35;116;353;12;0;2011;2111;HOSPITAL DE OFTALMOLOGIA SANTA LUCIA;
Urgencia;Total Hospital;4157;65;4222;4143;0;4143;65;4208;18948;3764;5191;1031;1986;91;7981;0;2011;2111;HOSPITAL DE OFTALMOLOGIA SANTA LUCIA;
Medicina;Clínica Médica;0;142;142;27;13;40;68;108;11680;9867;32;2703;8448;9136;338;1204;2011;2117;HOSPITAL DE SALUD MENTAL J. T. BORDA;
Medicina;Neurología;0;8;8;2;0;2;18;20;5110;3431;14;94;6714;17155;143;0;2011;2117;HOSPITAL DE SALUD MENTAL J. T. BORDA;
Medicina;Psicopatologia Y Salud Mental;891;886;1777;942;6;948;960;1908;275642;246614;75518;67565;8947;12925;253;31;2011;2117;HOSPITAL DE SALUD MENTAL J. T. BORDA;
Medicina;Subtotal Medicina;891;1036;1927;971;19;990;1046;2036;292432;259912;80118;71209;8888;12766;254;93;2011;2117;HOSPITAL DE SALUD MENTAL J. T. BORDA;
Cirugia;Cirugía General;0;30;30;3;1;4;20;24;3650;2707;10;742;7416;11279;24;417;2011;2117;HOSPITAL DE SALUD MENTAL J. T. BORDA;
Cirugia;Subtotal Cirugia;0;30;30;3;1;4;20;24;3650;2707;10;742;7416;11279;24;417;2011;2117;HOSPITAL DE SALUD MENTAL J. T. BORDA;
Cirugia;Total Hospital;891;1066;1957;974;20;994;1066;2060;296082;262619;81118;7195;887;2642;123;201;2011;2117;HOSPITAL DE SALUD MENTAL J. T. BORDA;
Medicina;Clínica Médica;0;63;63;10;8;18;44;62;8395;4884;23;1338;5818;7877;27;129;2011;2116;HOSPITAL DE SALUD MENTAL BRAULIO MOYANO;
Medicina;Psicopatologia Y Salud Mental;1064;1086;2150;1078;13;1091;1122;2213;347428;313065;95186;85771;9011;14147;232;59;2011;2116;HOSPITAL DE SALUD MENTAL BRAULIO MOYANO;
Medicina;Subtotal Medicina;1064;1149;2213;1088;21;1109;1166;2275;355823;317949;97486;87109;8936;13976;233;92;2011;2116;HOSPITAL DE SALUD MENTAL BRAULIO MOYANO;
Cirugia;Total Hospital;1064;1224;2288;1104;24;1128;1224;2352;367503;322896;100686;88465;8786;28626;112;213;2011;2116;HOSPITAL DE SALUD MENTAL BRAULIO MOYANO;
Pediatria;Psiquiatria;277;99;376;279;0;279;99;378;20449;13271;5602;3636;649;3511;675;0;2011;2165;HOSPITAL INFANTO JUVENIL C. TOBAR GARCIA;
Pediatria;Subtotal Pediatria;277;99;376;279;0;279;99;378;20449;13271;5602;3636;649;3511;675;0;2011;2165;HOSPITAL INFANTO JUVENIL C. TOBAR GARCIA;
Pediatria;Total Hospital;277;99;376;279;0;279;99;378;20449;13271;5602;3636;649;4757;498;0;2011;2165;HOSPITAL INFANTO JUVENIL C. TOBAR GARCIA;
Medicina;Psicopatologia y Salud Mental;15;293;308;266;0;266;38;304;18277;17654;;;;;;;2011;2108;HOSPITAL DE EMERGENCIAS PSIQUIATRICAS TORCUATO DE ALVEAR;
Medicina;Adolescencia;29;64;93;74;0;74;10;84;5896;5278;1615;1446;8952;6283;52;0;2011;2108;HOSPITAL DE EMERGENCIAS PSIQUIATRICAS TORCUATO DE ALVEAR;
Medicina;Subtotal Medicina;44;357;401;340;0;340;48;388;24173;22932;6623;6283;9487;591;586;0;2011;2108;HOSPITAL DE EMERGENCIAS PSIQUIATRICAS TORCUATO DE ALVEAR;
Urgencia;Emergencia;489;48;537;181;1;182;357;539;5969;5644;1635;1546;9456;1047;3296;19;2011;2108;HOSPITAL DE EMERGENCIAS PSIQUIATRICAS TORCUATO DE ALVEAR;
Urgencia;Subtotal Urgencia;489;48;537;181;1;182;357;539;5969;5644;1635;1546;9456;1047;3296;19;2011;2108;HOSPITAL DE EMERGENCIAS PSIQUIATRICAS TORCUATO DE ALVEAR;
Urgencia;Total Hospital;533;405;938;521;1;522;405;927;30142;28576;8258;7829;948;5474;632;19;2011;2108;HOSPITAL DE EMERGENCIAS PSIQUIATRICAS TORCUATO DE ALVEAR;
Medicina;Fisiatría;95;3;98;84;0;84;2;86;25229;19687;6912;5394;7803;22892;124;0;2011;2113;HOSPITAL DE REHABILITACION M. ROCCA;
Medicina;Subtotal Medicina;95;3;98;84;0;84;2;86;25229;19687;6912;5394;7803;22892;124;0;2011;2113;HOSPITAL DE REHABILITACION M. ROCCA;
Cirugia;Cirugía General;100;1;101;103;0;103;2;105;2191;1076;6;295;4911;1025;1749;0;2011;2113;HOSPITAL DE REHABILITACION M. ROCCA;
Cirugia;Subtotal Cirugia;100;1;101;103;0;103;2;105;2191;1076;6;295;4911;1025;1749;0;2011;2113;HOSPITAL DE REHABILITACION M. ROCCA;
Cirugia;Total Hospital;195;4;199;187;0;187;4;191;27420;20763;7512;5688;7572;11103;249;0;2011;2113;HOSPITAL DE REHABILITACION M. ROCCA;
Medicina;Fisiatría;83;6;89;84;0;84;3;87;18250;7586;50;2078;4157;872;174;0;2011;2114;INSTITUTO DE REHABILITACION PSICOFISICA (I.R.E.P.);
Medicina;Subtotal Medicina;83;6;89;84;0;84;3;87;18250;7586;50;2078;4157;872;174;0;2011;2114;INSTITUTO DE REHABILITACION PSICOFISICA (I.R.E.P.);
Cirugia;Cirugía General;218;33;251;215;0;215;36;251;1843;451;505;124;2447;18;4971;0;2011;2114;INSTITUTO DE REHABILITACION PSICOFISICA (I.R.E.P.);
Cirugia;Subtotal Cirugia;218;33;251;215;0;215;36;251;1843;451;505;124;2447;18;4971;0;2011;2114;INSTITUTO DE REHABILITACION PSICOFISICA (I.R.E.P.);
Cirugia;Total Hospital;301;39;340;299;0;299;39;338;20093;8037;5505;2202;40;2688;543;0;2011;2114;INSTITUTO DE REHABILITACION PSICOFISICA (I.R.E.P.);
Medicina;Terapia Prolongada;845;57;902;705;11;716;186;902;3858;2930;1057;803;7595;325;8534;122;2011;2115;HOSPITAL DE REHABILITACION RESPIRATORIA MARIA FERRER;
Medicina;Terapia Intermedia;479;290;769;622;25;647;128;775;7200;6195;1973;1697;8604;799;3929;323;2011;2115;HOSPITAL DE REHABILITACION RESPIRATORIA MARIA FERRER;
Medicina;Subtotal Medicina;1324;347;1671;1327;36;1363;314;1677;11058;9125;303;25;8252;544;5535;215;2011;2115;HOSPITAL DE REHABILITACION RESPIRATORIA MARIA FERRER;
Urgencia;Terapia Intensiva;161;216;377;82;48;130;249;379;2919;2339;8;641;8013;617;4739;1266;2011;2115;HOSPITAL DE REHABILITACION RESPIRATORIA MARIA FERRER;
Urgencia;Subtotal Urgencia;161;216;377;82;48;130;249;379;2919;2339;8;641;8013;617;4739;1266;2011;2115;HOSPITAL DE REHABILITACION RESPIRATORIA MARIA FERRER;
Urgencia;Total Hospital;1485;563;2048;1409;84;1493;563;2056;13977;11464;3829;3141;8202;768;3899;563;2011;2115;HOSPITAL DE REHABILITACION RESPIRATORIA MARIA FERRER;
Medicina;Cardiología;44;185;229;165;4;169;59;228;3660;1415;10;387;3866;621;228;175;2012;2126;HOSPITAL GENERAL DE AGUDOS DR. T. ALVAREZ;
Medicina;Clínica Médica;302;810;1112;885;92;977;137;1114;16483;12764;4504;3487;7744;1146;2474;826;2012;2126;HOSPITAL GENERAL DE AGUDOS DR. T. ALVAREZ;
Medicina;Neurología;4;24;28;20;3;23;6;29;768;256;21;7;3333;883;1382;1034;2012;2126;HOSPITAL GENERAL DE AGUDOS DR. T. ALVAREZ;
Medicina;Psicopatologia Y Salud Mental;16;82;98;91;0;91;3;94;7320;5073;20;1386;693;5397;47;0;2012;2126;HOSPITAL GENERAL DE AGUDOS DR. T. ALVAREZ;
Medicina;Unidad Coronaria;61;173;234;73;16;89;144;233;1846;1294;504;354;701;555;462;687;2012;2126;HOSPITAL GENERAL DE AGUDOS DR. T. ALVAREZ;
Medicina;Subtotal Medicina;427;1274;1701;1234;115;1349;349;1698;30077;20802;8218;5684;6916;1225;2066;677;2012;2126;HOSPITAL GENERAL DE AGUDOS DR. T. ALVAREZ;
Cirugia;Cirugía General;465;323;788;743;1;744;52;796;6588;5191;18;1418;7879;652;4422;13;2012;2126;HOSPITAL GENERAL DE AGUDOS DR. T. ALVAREZ;
Cirugia;Ginecología;161;49;210;177;1;178;23;201;1836;1101;502;301;5997;548;4007;5;2012;2126;HOSPITAL GENERAL DE AGUDOS DR. T. ALVAREZ;
Cirugia;Ortopedia Y Traumatología;310;193;503;429;6;435;68;503;8293;4314;2266;1179;5202;858;222;119;2012;2126;HOSPITAL GENERAL DE AGUDOS DR. T. ALVAREZ;
Cirugia;Urología;85;14;99;93;0;93;4;97;794;418;217;114;5264;431;4471;0;2012;2126;HOSPITAL GENERAL DE AGUDOS DR. T. ALVAREZ;
Cirugia;Subtotal Cirugia;1021;579;1600;1442;8;1450;147;1597;17511;11024;4784;3012;6295;69;3338;5;2012;2126;HOSPITAL GENERAL DE AGUDOS DR. T. ALVAREZ;
Pediatria;Recien Nacido Sano;1036;283;1319;1251;0;1251;76;1327;6345;3497;1734;955;5511;264;7655;0;2012;2126;HOSPITAL GENERAL DE AGUDOS DR. T. ALVAREZ;
Pediatria;Neonatología;386;77;463;174;4;178;286;464;2759;1952;754;533;7075;421;6155;86;2012;2126;HOSPITAL GENERAL DE AGUDOS DR. T. ALVAREZ;
Pediatria;Pediatría;1159;5;1164;1156;2;1158;2;1160;6918;3690;189;1008;5334;318;6137;17;2012;2126;HOSPITAL GENERAL DE AGUDOS DR. T. ALVAREZ;
Pediatria;Subtotal Pediatria;2581;365;2946;2581;6;2587;364;2951;16022;9139;4378;2497;5704;31;6741;2;2012;2126;HOSPITAL GENERAL DE AGUDOS DR. T. ALVAREZ;
Tocoginecologia;Obstetricia;1757;15;1772;1745;0;1745;35;1780;8368;5533;2286;1512;6612;311;7785;0;2012;2126;HOSPITAL GENERAL DE AGUDOS DR. T. ALVAREZ;
Tocoginecologia;Subtotal Tocoginecologia;1757;15;1772;1745;0;1745;35;1780;8368;5533;2286;1512;6612;311;7785;0;2012;2126;HOSPITAL GENERAL DE AGUDOS DR. T. ALVAREZ;
Urgencia;Guardia Del Día;1809;10;1819;326;53;379;1436;1815;2200;732;601;2;3327;4;30195;292;2012;2126;HOSPITAL GENERAL DE AGUDOS DR. T. ALVAREZ;
Urgencia;Terapia Intensiva;30;243;273;37;79;116;155;271;2897;1865;792;51;6438;688;3424;2915;2012;2126;HOSPITAL GENERAL DE AGUDOS DR. T. ALVAREZ;
Urgencia;Subtotal Urgencia;1839;253;2092;363;132;495;1591;2086;5097;2597;1393;71;5095;124;14979;633;2012;2126;HOSPITAL GENERAL DE AGUDOS DR. T. ALVAREZ;
Urgencia;Total Hospital;7625;2486;10111;7365;261;7626;2486;10112;77075;49095;21059;13414;637;644;3621;342;2012;2126;HOSPITAL GENERAL DE AGUDOS DR. T. ALVAREZ;
Medicina;Cardiología Intervencionista;252;0;252;252;0;252;0;252;404;252;11;69;6238;1;2283;0;2012;2122;HOSPITAL GENERAL DE AGUDOS DR C. ARGERICH;
Medicina;Cardiología;266;358;624;521;12;533;92;625;9028;5893;2467;161;6527;943;2534;192;2012;2122;HOSPITAL GENERAL DE AGUDOS DR C. ARGERICH;
Medicina;Clínica Médica;332;385;717;525;51;576;141;717;12444;10643;34;2908;8553;1484;2109;711;2012;2122;HOSPITAL GENERAL DE AGUDOS DR C. ARGERICH;
Medicina;Unidad Coronaria;291;142;433;66;40;106;326;432;2928;2326;8;636;7944;538;54;926;2012;2122;HOSPITAL GENERAL DE AGUDOS DR C. ARGERICH;
Medicina;Subtotal Medicina;1141;885;2026;1364;103;1467;559;2026;24804;19114;6777;5222;7706;943;299;508;2012;2122;HOSPITAL GENERAL DE AGUDOS DR C. ARGERICH;
Cirugia;Cirugía General;2904;182;3086;2897;34;2931;152;3083;20130;16496;55;4507;8195;535;5605;11;2012;2122;HOSPITAL GENERAL DE AGUDOS DR C. ARGERICH;
Cirugia;Cirugía Cardiovascular;165;73;238;157;4;161;80;241;5734;3080;1567;842;5371;1278;1538;166;2012;2122;HOSPITAL GENERAL DE AGUDOS DR C. ARGERICH;
Cirugia;Ginecología;345;34;379;354;3;357;23;380;4758;4494;13;1228;9445;1183;2923;79;2012;2122;HOSPITAL GENERAL DE AGUDOS DR C. ARGERICH;
Cirugia;Neurocirugía;274;107;381;297;10;307;68;375;8538;6070;2333;1658;7109;1619;1608;267;2012;2122;HOSPITAL GENERAL DE AGUDOS DR C. ARGERICH;
Cirugia;Ortopedia Y Traumatología;486;68;554;500;11;511;39;550;7992;5731;2184;1566;7171;1042;2519;2;2012;2122;HOSPITAL GENERAL DE AGUDOS DR C. ARGERICH;
Cirugia;Urología;199;40;239;215;0;215;23;238;3166;2136;865;584;6747;897;2751;0;2012;2122;HOSPITAL GENERAL DE AGUDOS DR C. ARGERICH;
Cirugia;Trasplante Renal;390;69;459;417;8;425;41;466;7686;4950;21;1352;644;1062;2219;172;2012;2122;HOSPITAL GENERAL DE AGUDOS DR C. ARGERICH;
Cirugia;Subtotal Cirugia;4763;573;5336;4837;70;4907;426;5333;58004;42957;15848;11737;7406;805;3365;131;2012;2122;HOSPITAL GENERAL DE AGUDOS DR C. ARGERICH;
Pediatria;Recien Nacido Sano;2458;123;2581;2078;0;2078;511;2589;13542;6119;37;1672;4519;236;6997;0;2012;2122;HOSPITAL GENERAL DE AGUDOS DR C. ARGERICH;
Pediatria;Neonatología;101;511;612;462;27;489;123;612;9882;6438;27;1759;6515;1052;2267;441;2012;2122;HOSPITAL GENERAL DE AGUDOS DR C. ARGERICH;
Pediatria;Pediatría;635;5;640;638;0;638;1;639;6588;3691;18;1008;5603;578;355;0;2012;2122;HOSPITAL GENERAL DE AGUDOS DR C. ARGERICH;
Pediatria;Subtotal Pediatria;3194;639;3833;3178;27;3205;635;3840;30012;16248;82;4439;5414;423;4683;7;2012;2122;HOSPITAL GENERAL DE AGUDOS DR C. ARGERICH;
Tocoginecologia;Obstetricia;3093;22;3115;3075;1;3076;39;3115;13571;10543;3708;2881;7769;338;8401;3;2012;2122;HOSPITAL GENERAL DE AGUDOS DR C. ARGERICH;
Pediatria;Neonatología;98;504;602;401;21;422;173;595;9597;5867;2629;1607;6113;986;2263;353;2011;2122;HOSPITAL GENERAL DE AGUDOS DR C. ARGERICH;
Pediatria;Pediatría;673;15;688;690;0;690;3;693;6477;3467;1775;95;5353;5;3905;0;2011;2122;HOSPITAL GENERAL DE AGUDOS DR C. ARGERICH;
Pediatria;Subtotal Pediatria;2974;687;3661;2948;21;2969;680;3649;25633;14860;7023;4071;5797;407;5196;58;2011;2122;HOSPITAL GENERAL DE AGUDOS DR C. ARGERICH;
Tocoginecologia;Obstetricia;2901;31;2932;2876;1;2877;50;2927;13234;10265;3626;2812;7757;351;8073;3;2011;2122;HOSPITAL GENERAL DE AGUDOS DR C. ARGERICH;
Tocoginecologia;Subtotal Tocoginecologia;2901;31;2932;2876;1;2877;50;2927;13234;10265;3626;2812;7757;351;8073;3;2011;2122;HOSPITAL GENERAL DE AGUDOS DR C. ARGERICH;
Urgencia;Guardia Del Día;1370;11;1381;696;131;827;558;1385;6506;6477;1782;1775;9955;468;777;946;2011;2122;HOSPITAL GENERAL DE AGUDOS DR C. ARGERICH;
Urgencia;Terapia Intensiva;220;613;833;69;148;217;618;835;7691;6874;2107;1883;8938;823;3963;1772;2011;2122;HOSPITAL GENERAL DE AGUDOS DR C. ARGERICH;
Urgencia;Subtotal Urgencia;1590;624;2214;765;279;1044;1176;2220;14197;13351;389;3658;9404;601;5708;1257;2011;2122;HOSPITAL GENERAL DE AGUDOS DR C. ARGERICH;
Urgencia;Total Hospital;12439;2934;15373;11913;512;12425;2934;15359;132841;100643;36395;27573;7576;81;3414;412;2011;2122;HOSPITAL GENERAL DE AGUDOS DR C. ARGERICH;
Medicina;Cardiología;55;265;320;216;1;217;98;315;9120;3807;2499;1043;4174;1209;1261;32;2011;2123;HOSPITAL GENERAL DE AGUDOS DR. C. DURAND;
Medicina;Clínica Médica;1010;366;1376;1135;101;1236;127;1363;19781;15763;5419;4319;7969;1156;2515;741;2011;2123;HOSPITAL GENERAL DE AGUDOS DR. C. DURAND;
Medicina;Geriatría;315;130;445;327;88;415;27;442;10930;7804;2995;2138;714;1766;1476;1991;2011;2123;HOSPITAL GENERAL DE AGUDOS DR. C. DURAND;
Medicina;Unidad Coronaria;331;111;442;158;39;197;244;441;3974;2307;1089;632;5805;523;405;884;2011;2123;HOSPITAL GENERAL DE AGUDOS DR. C. DURAND;
Medicina;Subtotal Medicina;1711;872;2583;1836;229;2065;496;2561;43805;29681;12001;8132;6776;1159;2134;894;2011;2123;HOSPITAL GENERAL DE AGUDOS DR. C. DURAND;
Cirugia;Cirugía General;727;150;877;751;1;752;120;872;3850;3875;1055;1062;10065;444;8267;11;2011;2123;HOSPITAL GENERAL DE AGUDOS DR. C. DURAND;
Cirugia;Cirugía Cardiovascular;97;83;180;52;8;60;120;180;930;932;255;255;10022;518;7065;444;2011;2123;HOSPITAL GENERAL DE AGUDOS DR. C. DURAND;
Cirugia;Cirugía Plástica Y Reparadora - niÃ±os;25;1;26;26;0;26;0;26;53;53;15;15;100;204;17906;0;2011;2123;HOSPITAL GENERAL DE AGUDOS DR. C. DURAND;
Cirugia;Oftalmología;7;0;7;7;0;7;0;7;17;17;5;5;100;243;15029;0;2011;2123;HOSPITAL GENERAL DE AGUDOS DR. C. DURAND;
Cirugia;Ortopedia Y Traumatología;355;48;403;376;5;381;26;407;3983;3984;1091;1092;10003;979;373;123;2011;2123;HOSPITAL GENERAL DE AGUDOS DR. C. DURAND;
Cirugia;Otorrinolaringología;82;6;88;80;0;80;7;87;337;337;92;92;100;387;9423;0;2011;2123;HOSPITAL GENERAL DE AGUDOS DR. C. DURAND;
Cirugia;Urología;388;33;421;380;0;380;40;420;1256;1260;344;345;10032;3;12205;0;2011;2123;HOSPITAL GENERAL DE AGUDOS DR. C. DURAND;
Cirugia;Vascular Periférico;41;32;73;47;0;47;26;73;569;573;156;157;1007;785;4683;0;2011;2123;HOSPITAL GENERAL DE AGUDOS DR. C. DURAND;
Cirugia;Subtotal Cirugia;1722;353;2075;1719;14;1733;339;2072;10995;11031;3012;3022;10033;532;6878;68;2011;2123;HOSPITAL GENERAL DE AGUDOS DR. C. DURAND;
Pediatria;Recien Nacido Sano;1460;243;1703;1662;0;1662;41;1703;9135;5493;2503;1505;6013;323;6805;0;2011;2123;HOSPITAL GENERAL DE AGUDOS DR. C. DURAND;
Pediatria;Neonatología;454;184;638;238;11;249;388;637;7300;4490;20;123;6151;705;3185;173;2011;2123;HOSPITAL GENERAL DE AGUDOS DR. C. DURAND;
Pediatria;Pediatría;914;10;924;901;1;902;26;928;9480;4427;2597;1213;467;477;3573;11;2011;2123;HOSPITAL GENERAL DE AGUDOS DR. C. DURAND;
Pediatria;Subtotal Pediatria;2828;437;3265;2801;12;2813;455;3268;25915;14410;71;3948;556;441;4603;37;2011;2123;HOSPITAL GENERAL DE AGUDOS DR. C. DURAND;
Tocoginecologia;Tocoginecología;2881;24;2905;2877;1;2878;29;2907;19911;13910;5455;3811;6986;479;5329;3;2011;2123;HOSPITAL GENERAL DE AGUDOS DR. C. DURAND;
Tocoginecologia;Subtotal Tocoginecologia;2881;24;2905;2877;1;2878;29;2907;19911;13910;5455;3811;6986;479;5329;3;2011;2123;HOSPITAL GENERAL DE AGUDOS DR. C. DURAND;
Urgencia;Terapia Intermedia Pediátrica ;18;22;40;33;1;34;3;37;488;134;134;37;2746;362;2767;27;2011;2123;HOSPITAL GENERAL DE AGUDOS DR. C. DURAND;(*) Terapia Intermedia Pediátrica comenzó a funcionar a partir del mes de Diciembre de 2011
Urgencia;Guardia Del Día;516;24;540;170;29;199;343;542;3652;1840;1001;504;5038;339;5417;535;2011;2123;HOSPITAL GENERAL DE AGUDOS DR. C. DURAND;(*) Terapia Intermedia Pediátrica comenzó a funcionar a partir del mes de Diciembre de 2011
Urgencia;Terapia Intensiva;147;259;406;13;68;81;326;407;4377;2951;1199;808;6742;725;3394;1671;2011;2123;HOSPITAL GENERAL DE AGUDOS DR. C. DURAND;(*) Terapia Intermedia Pediátrica comenzó a funcionar a partir del mes de Diciembre de 2011
Medicina;Cardiología;48;206;254;203;6;209;44;253;3670;1730;1005;474;4714;684;2516;237;2011;2126;HOSPITAL GENERAL DE AGUDOS DR. T. ALVAREZ;
Medicina;Clínica Médica;351;1152;1503;1160;178;1338;169;1507;26844;18995;7355;5204;7076;126;2049;1181;2011;2126;HOSPITAL GENERAL DE AGUDOS DR. T. ALVAREZ;
Medicina;Neurología;15;47;62;44;9;53;10;63;1350;802;37;22;5941;1273;1703;1429;2011;2126;HOSPITAL GENERAL DE AGUDOS DR. T. ALVAREZ;
Medicina;Psicopatologia Y Salud Mental;18;72;90;87;0;87;5;92;6968;5242;1909;1436;7523;5698;482;0;2011;2126;HOSPITAL GENERAL DE AGUDOS DR. T. ALVAREZ;
Medicina;Unidad Coronaria;81;157;238;59;20;79;158;237;1844;1347;505;369;7305;568;4691;844;2011;2126;HOSPITAL GENERAL DE AGUDOS DR. T. ALVAREZ;
Medicina;Subtotal Medicina;513;1634;2147;1553;213;1766;386;2152;40676;28116;11144;7703;6912;1307;1931;99;2011;2126;HOSPITAL GENERAL DE AGUDOS DR. T. ALVAREZ;
Cirugia;Cirugía General;566;475;1041;951;5;956;84;1040;12096;6596;3314;1807;5453;634;3138;48;2011;2126;HOSPITAL GENERAL DE AGUDOS DR. T. ALVAREZ;
Cirugia;Ginecología;367;83;450;399;0;399;49;448;5802;2149;159;589;3704;48;2818;0;2011;2126;HOSPITAL GENERAL DE AGUDOS DR. T. ALVAREZ;
Cirugia;Ortopedia Y Traumatología;305;164;469;428;4;432;32;464;10276;5084;2815;1393;4947;1096;1648;86;2011;2126;HOSPITAL GENERAL DE AGUDOS DR. T. ALVAREZ;
Cirugia;Urología;147;13;160;148;0;148;11;159;1468;565;402;155;3849;355;3953;0;2011;2126;HOSPITAL GENERAL DE AGUDOS DR. T. ALVAREZ;
Cirugia;Subtotal Cirugia;1385;735;2120;1926;9;1935;176;2111;29642;14394;8121;3944;4856;682;2599;43;2011;2126;HOSPITAL GENERAL DE AGUDOS DR. T. ALVAREZ;
Pediatria;Recien Nacido Sano;1365;319;1684;1566;0;1566;108;1674;7159;4761;1961;1304;665;284;8535;0;2011;2126;HOSPITAL GENERAL DE AGUDOS DR. T. ALVAREZ;
Pediatria;Neonatología;435;106;541;218;4;222;319;541;3242;2422;888;664;7471;448;6091;74;2011;2126;HOSPITAL GENERAL DE AGUDOS DR. T. ALVAREZ;
Pediatria;Pediatría;1285;6;1291;1286;2;1288;4;1292;6892;3299;1888;904;4787;255;6842;15;2011;2126;HOSPITAL GENERAL DE AGUDOS DR. T. ALVAREZ;
Pediatria;Subtotal Pediatria;3085;431;3516;3070;6;3076;431;3507;17293;10482;4738;2872;6061;299;7402;17;2011;2126;HOSPITAL GENERAL DE AGUDOS DR. T. ALVAREZ;
Tocoginecologia;Obstetricia;2181;37;2218;2143;0;2143;58;2201;9405;6300;2577;1726;6699;286;8542;0;2011;2126;HOSPITAL GENERAL DE AGUDOS DR. T. ALVAREZ;
Tocoginecologia;Subtotal Tocoginecologia;2181;37;2218;2143;0;2143;58;2201;9405;6300;2577;1726;6699;286;8542;0;2011;2126;HOSPITAL GENERAL DE AGUDOS DR. T. ALVAREZ;
Urgencia;Guardia Del Día;2376;26;2402;440;74;514;1894;2408;3672;1535;1006;421;418;64;23936;307;2011;2126;HOSPITAL GENERAL DE AGUDOS DR. T. ALVAREZ;
Urgencia;Terapia Intensiva;16;260;276;18;82;100;178;278;2787;1915;764;525;6871;689;3641;295;2011;2126;HOSPITAL GENERAL DE AGUDOS DR. T. ALVAREZ;
Urgencia;Subtotal Urgencia;2392;286;2678;458;156;614;2072;2686;6459;3450;177;945;5341;128;15179;581;2011;2126;HOSPITAL GENERAL DE AGUDOS DR. T. ALVAREZ;
Urgencia;Total Hospital;9556;3123;12679;9150;384;9534;3123;12657;103475;62742;28349;1719;6063;658;3363;403;2011;2126;HOSPITAL GENERAL DE AGUDOS DR. T. ALVAREZ;
Medicina;Cardiología Intervencionista;229;3;232;225;0;225;7;232;496;222;136;61;4476;96;17073;0;2011;2122;HOSPITAL GENERAL DE AGUDOS DR C. ARGERICH;
Medicina;Cardiología;240;390;630;529;10;539;97;636;8695;6717;2382;184;7725;1056;267;157;2011;2122;HOSPITAL GENERAL DE AGUDOS DR C. ARGERICH;
Medicina;Clínica Médica;312;411;723;514;66;580;141;721;12410;10044;34;2752;8093;1393;2121;915;2011;2122;HOSPITAL GENERAL DE AGUDOS DR C. ARGERICH;
Medicina;Unidad Coronaria;312;129;441;54;52;106;337;443;2806;2355;769;645;8393;532;5762;1174;2011;2122;HOSPITAL GENERAL DE AGUDOS DR C. ARGERICH;
Medicina;Subtotal Medicina;1093;933;2026;1322;128;1450;582;2032;24407;19338;6687;5298;7923;952;3039;63;2011;2122;HOSPITAL GENERAL DE AGUDOS DR C. ARGERICH;
Cirugia;Cirugía General;2042;205;2247;2039;48;2087;153;2240;18563;15398;5086;4219;8295;687;4404;214;2011;2122;HOSPITAL GENERAL DE AGUDOS DR C. ARGERICH;
Cirugia;Cirugía Cardiovascular;141;97;238;152;5;157;82;239;4986;3217;1366;881;6452;1346;175;209;2011;2122;HOSPITAL GENERAL DE AGUDOS DR C. ARGERICH;
Cirugia;Ginecología;417;42;459;436;2;438;19;457;4745;4396;13;1204;9264;962;3515;44;2011;2122;HOSPITAL GENERAL DE AGUDOS DR C. ARGERICH;
Cirugia;Neurocirugía;243;113;356;276;10;286;76;362;8457;6092;2317;1669;7204;1683;1562;276;2011;2122;HOSPITAL GENERAL DE AGUDOS DR C. ARGERICH;
Cirugia;Ortopedia Y Traumatología;359;73;432;384;10;394;36;430;7512;5861;2058;1606;7802;1363;2089;233;2011;2122;HOSPITAL GENERAL DE AGUDOS DR C. ARGERICH;
Cirugia;Urología;242;32;274;246;2;248;24;272;3535;3073;968;842;8693;113;2808;74;2011;2122;HOSPITAL GENERAL DE AGUDOS DR C. ARGERICH;
Cirugia;Trasplante Renal;437;97;534;469;6;475;56;531;7572;4792;2075;1313;6329;902;256;113;2011;2122;HOSPITAL GENERAL DE AGUDOS DR C. ARGERICH;
Cirugia;Subtotal Cirugia;3881;659;4540;4002;83;4085;446;4531;55370;42829;1517;11734;7735;945;2987;183;2011;2122;HOSPITAL GENERAL DE AGUDOS DR C. ARGERICH;
Pediatria;Recien Nacido Sano;2203;168;2371;1857;0;1857;504;2361;9559;5526;2619;1514;5781;234;9015;0;2011;2122;HOSPITAL GENERAL DE AGUDOS DR C. ARGERICH;
Urgencia;Subtotal Urgencia;681;305;986;216;98;314;672;986;8517;4925;2333;1349;5783;499;4226;994;2011;2123;HOSPITAL GENERAL DE AGUDOS DR. C. DURAND;(*) Terapia Intermedia Pediátrica comenzó a funcionar a partir del mes de Diciembre de 2011
Urgencia;Total Hospital;9823;1991;11814;9449;354;9803;1991;11794;109143;73957;29902;20262;6776;754;3278;361;2011;2123;HOSPITAL GENERAL DE AGUDOS DR. C. DURAND;(*) Terapia Intermedia Pediátrica comenzó a funcionar a partir del mes de Diciembre de 2011
Medicina;Cardiología;94;104;198;133;7;140;57;197;1944;1118;533;306;5751;568;3699;355;2011;2127;HOSPITAL GENERAL DE AGUDOS DR. J. A. FERNANDEZ;
Medicina;Clínica Médica;1281;375;1656;1220;143;1363;281;1644;28652;25223;785;691;8803;1534;2094;87;2011;2127;HOSPITAL GENERAL DE AGUDOS DR. J. A. FERNANDEZ;
Medicina;Unidad Coronaria;405;76;481;254;40;294;187;481;3650;2076;10;569;5688;432;481;832;2011;2127;HOSPITAL GENERAL DE AGUDOS DR. J. A. FERNANDEZ;
Medicina;Cardiologia;23;73;96;71;4;75;21;96;976;600;267;164;6148;625;359;417;2011;2127;HOSPITAL GENERAL DE AGUDOS DR. J. A. FERNANDEZ;
Medicina;Subtotal Medicina;1803;628;2431;1678;194;1872;546;2418;35222;29017;965;795;8238;12;2506;802;2011;2127;HOSPITAL GENERAL DE AGUDOS DR. J. A. FERNANDEZ;
Cirugia;Cirugía General;936;302;1238;991;19;1010;221;1231;16072;14625;4403;4007;91;1188;2796;154;2011;2127;HOSPITAL GENERAL DE AGUDOS DR. J. A. FERNANDEZ;
Cirugia;Ginecología;639;355;994;891;3;894;102;996;7301;5734;20;1571;7854;576;4979;3;2011;2127;HOSPITAL GENERAL DE AGUDOS DR. J. A. FERNANDEZ;
Cirugia;Neurocirugía;186;124;310;207;1;208;104;312;4381;4039;12;1107;9219;1295;2599;32;2011;2127;HOSPITAL GENERAL DE AGUDOS DR. J. A. FERNANDEZ;
Cirugia;Ortopedia Y Traumatología;1007;146;1153;1009;7;1016;142;1158;16888;13862;4627;3798;8208;1197;2503;6;2011;2127;HOSPITAL GENERAL DE AGUDOS DR. J. A. FERNANDEZ;
Cirugia;Urología;208;39;247;217;1;218;30;248;3650;3364;10;922;9216;1356;248;4;2011;2127;HOSPITAL GENERAL DE AGUDOS DR. J. A. FERNANDEZ;
Cirugia;Subtotal Cirugia;2976;966;3942;3315;31;3346;599;3945;48292;41624;13231;11404;8619;1055;2982;79;2011;2127;HOSPITAL GENERAL DE AGUDOS DR. J. A. FERNANDEZ;
Pediatria;Recien Nacido Sano;1672;20;1692;1575;0;1575;118;1693;10209;5021;2797;1376;4918;297;6053;0;2011;2127;HOSPITAL GENERAL DE AGUDOS DR. J. A. FERNANDEZ;
Pediatria;Neonatología;389;119;508;458;25;483;19;502;8041;5978;2203;1638;7434;1191;2279;498;2011;2127;HOSPITAL GENERAL DE AGUDOS DR. J. A. FERNANDEZ;
Pediatria;Pediatría;705;1;706;708;0;708;2;710;6570;2891;18;792;44;407;3944;0;2011;2127;HOSPITAL GENERAL DE AGUDOS DR. J. A. FERNANDEZ;
Pediatria;Subtotal Pediatria;2766;140;2906;2741;25;2766;139;2905;24820;13890;68;3805;5596;478;4272;86;2011;2127;HOSPITAL GENERAL DE AGUDOS DR. J. A. FERNANDEZ;
Tocoginecologia;Obstetricia;2530;9;2539;2189;0;2189;349;2538;10961;8105;3003;2221;7394;319;8452;0;2011;2127;HOSPITAL GENERAL DE AGUDOS DR. J. A. FERNANDEZ;
Tocoginecologia;Subtotal Tocoginecologia;2530;9;2539;2189;0;2189;349;2538;10961;8105;3003;2221;7394;319;8452;0;2011;2127;HOSPITAL GENERAL DE AGUDOS DR. J. A. FERNANDEZ;
Urgencia;Terapia Intermedia;45;293;338;39;19;58;282;340;4330;4042;1186;1107;9335;1189;2866;559;2011;2127;HOSPITAL GENERAL DE AGUDOS DR. J. A. FERNANDEZ;
Urgencia;Toxicología;232;15;247;208;1;209;38;247;2920;1340;8;367;4589;543;3088;4;2011;2127;HOSPITAL GENERAL DE AGUDOS DR. J. A. FERNANDEZ;
Urgencia;Terapia Intensiva;201;325;526;7;98;105;423;528;6474;5183;1774;142;8006;982;2977;1856;2011;2127;HOSPITAL GENERAL DE AGUDOS DR. J. A. FERNANDEZ;
Urgencia;Subtotal Urgencia;478;633;1111;254;118;372;743;1115;13724;10565;376;2895;7698;948;2965;1058;2011;2127;HOSPITAL GENERAL DE AGUDOS DR. J. A. FERNANDEZ;
Urgencia;Total Hospital;10553;2376;12929;10177;368;10545;2376;12921;133019;103201;36444;28274;7758;979;2894;349;2011;2127;HOSPITAL GENERAL DE AGUDOS DR. J. A. FERNANDEZ;
Medicina;Clínica Médica;51;506;557;451;53;504;52;556;16522;15176;4527;4158;9185;2729;1228;953;2011;2161;HOSPITAL GENERAL DE AGUDOS J. A. PENNA;
Medicina;Subtotal Medicina;51;506;557;451;53;504;52;556;16522;15176;4527;4158;9185;2729;1228;953;2011;2161;HOSPITAL GENERAL DE AGUDOS J. A. PENNA;
Cirugia;Cirugía General;435;972;1407;1326;13;1339;71;1410;10963;7995;3004;219;7293;567;4694;92;2011;2161;HOSPITAL GENERAL DE AGUDOS J. A. PENNA;
Cirugia;Ortopedia Y Traumatología;29;262;291;268;6;274;14;288;5740;5242;1573;1436;9132;182;1831;208;2011;2161;HOSPITAL GENERAL DE AGUDOS J. A. PENNA;
Cirugia;Urología;61;232;293;273;2;275;16;291;2499;2358;685;646;9436;81;425;69;2011;2161;HOSPITAL GENERAL DE AGUDOS J. A. PENNA;
Cirugia;Subtotal Cirugia;525;1466;1991;1867;21;1888;101;1989;19202;15595;5261;4273;8122;784;3781;106;2011;2161;HOSPITAL GENERAL DE AGUDOS J. A. PENNA;
Pediatria;Recien Nacido Sano;3014;451;3465;3254;0;3254;214;3468;17668;12916;4841;3539;731;372;7164;0;2011;2161;HOSPITAL GENERAL DE AGUDOS J. A. PENNA;
Pediatria;Neonatología;643;160;803;377;22;399;398;797;8440;5851;2312;1603;6932;734;3447;276;2011;2161;HOSPITAL GENERAL DE AGUDOS J. A. PENNA;
Pediatria;Pediatría;383;2;385;378;3;381;0;381;1627;1605;446;44;9865;421;8547;79;2011;2161;HOSPITAL GENERAL DE AGUDOS J. A. PENNA;
Pediatria;Subtotal Pediatria;4040;613;4653;4009;25;4034;612;4646;27735;20372;7599;5581;7345;438;6114;54;2011;2161;HOSPITAL GENERAL DE AGUDOS J. A. PENNA;
Tocoginecologia;Tocoginecología;5397;258;5655;5386;3;5389;262;5651;25379;22073;6953;6047;8697;391;8127;5;2011;2161;HOSPITAL GENERAL DE AGUDOS J. A. PENNA;
Tocoginecologia;Subtotal Tocoginecologia;5397;258;5655;5386;3;5389;262;5651;25379;22073;6953;6047;8697;391;8127;5;2011;2161;HOSPITAL GENERAL DE AGUDOS J. A. PENNA;
Urgencia;Terapia Intermedia;1;102;103;5;3;8;94;102;728;629;199;172;864;617;5114;294;2011;2161;HOSPITAL GENERAL DE AGUDOS J. A. PENNA;
Urgencia;Guardia Del Día;3213;1;3214;1203;117;1320;1900;3220;5437;5455;149;1495;10033;169;21617;363;2011;2161;HOSPITAL GENERAL DE AGUDOS J. A. PENNA;
Urgencia;Terapia Intensiva;4;268;272;10;70;80;193;273;2540;2441;696;669;961;894;3923;2564;2011;2161;HOSPITAL GENERAL DE AGUDOS J. A. PENNA;
Urgencia;Subtotal Urgencia;3218;371;3589;1218;190;1408;2187;3595;8705;8525;2385;2336;9793;237;15074;529;2011;2161;HOSPITAL GENERAL DE AGUDOS J. A. PENNA;
Urgencia;Total Hospital;13231;3214;16445;12931;292;13223;3214;16437;97543;81741;26724;22395;838;618;4948;221;2011;2161;HOSPITAL GENERAL DE AGUDOS J. A. PENNA;
Medicina;Psicopatologia Y Salud Mental;109;75;184;194;0;194;0;194;7307;5506;2002;1508;7535;2838;969;0;2011;2163;HOSPITAL GENERAL DE AGUDOS P. PIÑERO;
Medicina;Subtotal Medicina;109;75;184;194;0;194;0;194;7307;5506;2002;1508;7535;2838;969;0;2011;2163;HOSPITAL GENERAL DE AGUDOS P. PIÑERO;
Cirugia;Ginecología;420;30;450;426;5;431;19;450;4382;1828;1201;501;4172;406;3748;111;2011;2163;HOSPITAL GENERAL DE AGUDOS P. PIÑERO;
Cirugia;Subtotal Cirugia;420;30;450;426;5;431;19;450;4382;1828;1201;501;4172;406;3748;111;2011;2163;HOSPITAL GENERAL DE AGUDOS P. PIÑERO;
Pediatria;Recien Nacido Sano;2429;0;2429;2078;0;2078;323;2401;9514;7320;2607;2005;7694;305;9211;0;2011;2163;HOSPITAL GENERAL DE AGUDOS P. PIÑERO;
Pediatria;Neonatología;82;324;406;371;21;392;2;394;6570;3524;18;965;5364;894;2189;533;2011;2163;HOSPITAL GENERAL DE AGUDOS P. PIÑERO;
Pediatria;Pediatría;1542;6;1548;1539;3;1542;1;1543;8644;4484;2368;1228;5187;291;6515;19;2011;2163;HOSPITAL GENERAL DE AGUDOS P. PIÑERO;
Pediatria;Subtotal Pediatria;4053;330;4383;3988;24;4012;326;4338;24728;15328;6775;4199;6199;353;6403;55;2011;2163;HOSPITAL GENERAL DE AGUDOS P. PIÑERO;
Tocoginecologia;Obstetricia;3318;40;3358;3284;0;3284;38;3322;22070;12760;6047;3496;5782;384;5494;0;2011;2163;HOSPITAL GENERAL DE AGUDOS P. PIÑERO;
Tocoginecologia;Subtotal Tocoginecologia;3318;40;3358;3284;0;3284;38;3322;22070;12760;6047;3496;5782;384;5494;0;2011;2163;HOSPITAL GENERAL DE AGUDOS P. PIÑERO;
Urgencia;Guardia Del Día;3225;47;3272;1173;195;1368;1902;3270;4227;4151;1158;1137;982;127;28236;596;2011;2163;HOSPITAL GENERAL DE AGUDOS P. PIÑERO;
Urgencia;Terapia Intensiva;12;301;313;28;87;115;198;313;2915;2078;799;569;7129;664;3919;278;2011;2163;HOSPITAL GENERAL DE AGUDOS P. PIÑERO;
Urgencia;Subtotal Urgencia;3237;348;3585;1201;282;1483;2100;3583;7142;6229;1957;1707;8722;174;18311;787;2011;2163;HOSPITAL GENERAL DE AGUDOS P. PIÑERO;
Area Indiferenciada;Area Indiferenciada;945;2002;2947;2434;176;2610;342;2952;51697;36055;14164;9878;6974;1221;2084;596;2011;2163;HOSPITAL GENERAL DE AGUDOS P. PIÑERO;
Area Indiferenciada;Subtotal Area Indiferenciada;945;2002;2947;2434;176;2610;342;2952;51697;36055;14164;9878;6974;1221;2084;596;2011;2163;HOSPITAL GENERAL DE AGUDOS P. PIÑERO;
Area Indiferenciada;Total Hospital;12082;2825;14907;11527;487;12014;2825;14839;117326;77706;32144;21289;6623;647;3738;405;2011;2163;HOSPITAL GENERAL DE AGUDOS P. PIÑERO;
Medicina;Cardiología;0;130;130;110;1;111;19;130;1730;598;474;164;3457;46;2743;77;2011;2125;HOSPITAL GENERAL DE AGUDOS DR. I. PIROVANO;
Medicina;Clínica Médica;1136;440;1576;1207;182;1389;185;1574;23176;20386;635;5585;8796;1295;2479;1156;2011;2125;HOSPITAL GENERAL DE AGUDOS DR. I. PIROVANO;
Medicina;Unidad Coronaria;276;52;328;162;16;178;149;327;2182;1933;598;53;8859;591;547;489;2011;2125;HOSPITAL GENERAL DE AGUDOS DR. I. PIROVANO;
Medicina;Subtotal Medicina;1412;622;2034;1479;199;1678;353;2031;27088;22917;7421;6279;846;1128;2737;98;2011;2125;HOSPITAL GENERAL DE AGUDOS DR. I. PIROVANO;
Cirugia;Cirugía General;1399;191;1590;1363;39;1402;185;1587;21892;15160;5998;4153;6925;955;2646;246;2011;2125;HOSPITAL GENERAL DE AGUDOS DR. I. PIROVANO;
Cirugia;Ginecología;911;88;999;739;13;752;246;998;7337;5483;201;1502;7473;549;4965;13;2011;2125;HOSPITAL GENERAL DE AGUDOS DR. I. PIROVANO;
Cirugia;Neurocirugía;322;99;421;282;9;291;134;425;7137;3851;1955;1055;5396;906;2174;212;2011;2125;HOSPITAL GENERAL DE AGUDOS DR. I. PIROVANO;
Cirugia;Oftalmología;103;5;108;101;3;104;6;110;2555;921;7;252;3605;837;1571;273;2011;2125;HOSPITAL GENERAL DE AGUDOS DR. I. PIROVANO;
Cirugia;Ortopedia Y Traumatología;622;91;713;555;27;582;129;711;18958;11903;5194;3261;6279;1674;1369;38;2011;2125;HOSPITAL GENERAL DE AGUDOS DR. I. PIROVANO;
Cirugia;Otorrinolaringología;191;13;204;187;3;190;15;205;3260;1403;893;384;4304;684;2295;146;2011;2125;HOSPITAL GENERAL DE AGUDOS DR. I. PIROVANO;
Cirugia;Urología;292;54;346;314;2;316;32;348;4030;2277;1104;624;565;654;3152;57;2011;2125;HOSPITAL GENERAL DE AGUDOS DR. I. PIROVANO;
Cirugia;Subtotal Cirugia;3840;541;4381;3541;96;3637;747;4384;65169;40998;17855;11232;6291;935;2455;219;2011;2125;HOSPITAL GENERAL DE AGUDOS DR. I. PIROVANO;
Pediatria;Recien Nacido Sano;1194;0;1194;1058;0;1058;142;1200;12045;3955;33;1084;3284;33;3636;0;2011;2125;HOSPITAL GENERAL DE AGUDOS DR. I. PIROVANO;
Pediatria;Neonatología;145;147;292;283;8;291;3;294;3349;2518;918;69;7519;856;3204;272;2011;2125;HOSPITAL GENERAL DE AGUDOS DR. I. PIROVANO;
Pediatria;Pediatría;1008;4;1012;1006;0;1006;5;1011;10766;3499;295;959;325;346;3428;0;2011;2125;HOSPITAL GENERAL DE AGUDOS DR. I. PIROVANO;
Pediatria;Subtotal Pediatria;2347;151;2498;2347;8;2355;150;2505;26160;9972;7167;2732;3812;398;3495;32;2011;2125;HOSPITAL GENERAL DE AGUDOS DR. I. PIROVANO;
Tocoginecologia;Obstetricia;1896;11;1907;1876;0;1876;41;1917;12045;6768;33;1854;5619;353;5809;0;2011;2125;HOSPITAL GENERAL DE AGUDOS DR. I. PIROVANO;
Tocoginecologia;Subtotal Tocoginecologia;1896;11;1907;1876;0;1876;41;1917;12045;6768;33;1854;5619;353;5809;0;2011;2125;HOSPITAL GENERAL DE AGUDOS DR. I. PIROVANO;
Urgencia;Terapia Intermedia;35;126;161;23;15;38;122;160;1449;1299;397;356;8965;812;403;938;2011;2125;HOSPITAL GENERAL DE AGUDOS DR. I. PIROVANO;
Urgencia;Terapia Intensiva;118;240;358;8;71;79;278;357;2920;2804;8;768;9603;785;4463;1989;2011;2125;HOSPITAL GENERAL DE AGUDOS DR. I. PIROVANO;
Urgencia;Subtotal Urgencia;153;366;519;31;86;117;400;517;4369;4103;1197;1124;9391;794;4319;1663;2011;2125;HOSPITAL GENERAL DE AGUDOS DR. I. PIROVANO;
Urgencia;Total Hospital;9648;1691;11339;9274;389;9663;1691;11354;134831;84758;3694;23221;6286;877;2616;403;2011;2125;HOSPITAL GENERAL DE AGUDOS DR. I. PIROVANO;
Medicina;Cardiología;194;254;448;368;0;368;85;453;5104;2742;1398;751;5372;605;324;0;2011;2162;HOSPITAL GENERAL DE AGUDOS J. M. RAMOS MEJIA;
Medicina;Clínica Médica;676;959;1635;1248;148;1396;242;1638;34253;29997;9384;8218;8757;1831;1745;904;2011;2162;HOSPITAL GENERAL DE AGUDOS J. M. RAMOS MEJIA;
Medicina;Dermatología;86;9;95;82;0;82;14;96;3349;1677;918;459;5007;1747;1046;0;2011;2162;HOSPITAL GENERAL DE AGUDOS J. M. RAMOS MEJIA;
Medicina;Stroke ;5;13;18;9;0;9;8;17;1096;298;3;82;2719;1753;566;0;2011;2162;HOSPITAL GENERAL DE AGUDOS J. M. RAMOS MEJIA;
Medicina;Hematología;170;30;200;170;13;183;13;196;5039;3636;1381;996;7216;1855;142;663;2011;2162;HOSPITAL GENERAL DE AGUDOS J. M. RAMOS MEJIA;
Medicina;Neurología;347;163;510;425;4;429;71;500;5573;4478;1527;1227;8035;896;3275;8;2011;2162;HOSPITAL GENERAL DE AGUDOS J. M. RAMOS MEJIA;
Medicina;Tisiología;75;74;149;128;5;133;22;155;4986;3355;1366;919;6729;2165;1135;323;2011;2162;HOSPITAL GENERAL DE AGUDOS J. M. RAMOS MEJIA;
Medicina;Unidad Coronaria;297;135;432;146;33;179;251;430;2230;1877;611;514;8417;437;7038;767;2011;2162;HOSPITAL GENERAL DE AGUDOS J. M. RAMOS MEJIA;
Medicina;Subtotal Medicina;1850;1637;3487;2576;203;2779;706;3485;61630;48060;16885;13167;7798;1379;2064;582;2011;2162;HOSPITAL GENERAL DE AGUDOS J. M. RAMOS MEJIA;
Cirugia;Cirugía General;875;924;1799;1586;27;1613;179;1792;18935;12937;5188;3544;6832;722;3454;151;2011;2162;HOSPITAL GENERAL DE AGUDOS J. M. RAMOS MEJIA;
Cirugia;Cirugía Plástica Y Reparadora - niÃ±os;404;26;430;409;0;409;21;430;4986;1506;1366;413;302;35;3148;0;2011;2162;HOSPITAL GENERAL DE AGUDOS J. M. RAMOS MEJIA;
Cirugia;Ginecología;404;30;434;414;7;421;11;432;5594;3763;1533;1031;6727;871;2819;162;2011;2162;HOSPITAL GENERAL DE AGUDOS J. M. RAMOS MEJIA;
Cirugia;Oftalmología;149;2;151;150;0;150;1;151;815;196;223;54;2405;13;6763;0;2011;2162;HOSPITAL GENERAL DE AGUDOS J. M. RAMOS MEJIA;
Cirugia;Ortopedia Y Traumatología;287;101;388;350;6;356;35;391;10086;6856;2763;1878;6798;1753;1415;153;2011;2162;HOSPITAL GENERAL DE AGUDOS J. M. RAMOS MEJIA;
Cirugia;Otorrinolaringología;211;13;224;220;0;220;4;224;1653;624;453;171;3775;279;4946;0;2011;2162;HOSPITAL GENERAL DE AGUDOS J. M. RAMOS MEJIA;
Cirugia;Urología;309;46;355;319;7;326;26;352;6814;3961;1867;1085;5813;1125;1886;199;2011;2162;HOSPITAL GENERAL DE AGUDOS J. M. RAMOS MEJIA;
Cirugia;Subtotal Cirugia;2639;1142;3781;3448;47;3495;277;3772;48883;29843;13393;8176;6105;791;2816;125;2011;2162;HOSPITAL GENERAL DE AGUDOS J. M. RAMOS MEJIA;
Pediatria;Recien Nacido Sano;1589;0;1589;1518;0;1518;65;1583;5727;4387;1569;1202;766;277;10089;0;2011;2162;HOSPITAL GENERAL DE AGUDOS J. M. RAMOS MEJIA;
Pediatria;Neonatología;192;65;257;250;11;261;0;261;4362;2724;1195;746;6245;1044;2184;421;2011;2162;HOSPITAL GENERAL DE AGUDOS J. M. RAMOS MEJIA;
Pediatria;Pediatría;513;6;519;520;0;520;0;520;4776;2382;1308;653;4987;458;3974;0;2011;2162;HOSPITAL GENERAL DE AGUDOS J. M. RAMOS MEJIA;
Pediatria;Subtotal Pediatria;2294;71;2365;2288;11;2299;65;2364;14865;9493;4073;2601;6386;402;5805;47;2011;2162;HOSPITAL GENERAL DE AGUDOS J. M. RAMOS MEJIA;
Tocoginecologia;Obstetricia;2282;10;2292;2278;0;2278;10;2288;9186;8074;2517;2212;8789;353;9091;0;2011;2162;HOSPITAL GENERAL DE AGUDOS J. M. RAMOS MEJIA;
Tocoginecologia;Subtotal Tocoginecologia;2282;10;2292;2278;0;2278;10;2288;9186;8074;2517;2212;8789;353;9091;0;2011;2162;HOSPITAL GENERAL DE AGUDOS J. M. RAMOS MEJIA;
Urgencia;Guardia Del Día;2898;126;3024;808;229;1037;1983;3020;4687;5201;1284;1425;11097;172;23518;758;2011;2162;HOSPITAL GENERAL DE AGUDOS J. M. RAMOS MEJIA;
Urgencia;Terapia Intensiva;27;307;334;5;79;84;252;336;3660;3203;1003;878;8751;953;3351;2351;2011;2162;HOSPITAL GENERAL DE AGUDOS J. M. RAMOS MEJIA;
Urgencia;Subtotal Urgencia;2925;433;3358;813;308;1121;2235;3356;8347;8404;2287;2302;10068;25;14675;918;2011;2162;HOSPITAL GENERAL DE AGUDOS J. M. RAMOS MEJIA;
Urgencia;Total Hospital;11990;3293;15283;11403;569;11972;3293;15265;142911;103874;39154;28459;7268;868;3058;475;2011;2162;HOSPITAL GENERAL DE AGUDOS J. M. RAMOS MEJIA;
Medicina;Cardiología;37;162;199;164;0;164;36;200;4370;1413;1197;387;3233;707;167;0;2011;2119;HOSPITAL GENERAL DE AGUDOS B. RIVADAVIA;
Medicina;Clínica Médica;816;124;940;739;73;812;139;951;19844;14824;5437;4061;747;1559;1749;768;2011;2119;HOSPITAL GENERAL DE AGUDOS B. RIVADAVIA;
Medicina;Endocrinología;1;0;1;1;0;1;0;1;1;1;100;1;365;;;;2011;2119;HOSPITAL GENERAL DE AGUDOS B. RIVADAVIA;
Medicina;Neurología;5;0;5;5;0;5;0;5;11;11;3;3;100;22;16591;0;2011;2119;HOSPITAL GENERAL DE AGUDOS B. RIVADAVIA;
Medicina;Nutrición;58;6;64;60;0;60;4;64;4227;1510;1158;414;3572;2359;553;0;2011;2119;HOSPITAL GENERAL DE AGUDOS B. RIVADAVIA;
Medicina;Curieterapia;158;1;159;159;0;159;0;159;532;509;146;139;9568;32;10909;0;2011;2119;HOSPITAL GENERAL DE AGUDOS B. RIVADAVIA;
Medicina;Unidad Coronaria;193;75;268;69;11;80;191;271;2201;1446;603;396;657;534;4494;406;2011;2119;HOSPITAL GENERAL DE AGUDOS B. RIVADAVIA;
Medicina;Subtotal Medicina;1268;368;1636;1197;84;1281;370;1651;31186;19714;8544;5401;6321;1194;1932;509;2011;2119;HOSPITAL GENERAL DE AGUDOS B. RIVADAVIA;
Cirugia;Cirugía General;909;29;938;907;6;913;30;943;10849;4237;2972;1161;3905;449;3173;64;2011;2119;HOSPITAL GENERAL DE AGUDOS B. RIVADAVIA;
Cirugia;Cirugía Cardiovascular;21;12;33;26;0;26;8;34;2227;278;61;76;1248;818;557;0;2011;2119;HOSPITAL GENERAL DE AGUDOS B. RIVADAVIA;
Cirugia;Ginecología;492;7;499;485;3;488;10;498;4035;2207;1105;605;547;443;4505;6;2011;2119;HOSPITAL GENERAL DE AGUDOS B. RIVADAVIA;
Cirugia;Neurocirugía;93;28;121;95;0;95;28;123;2444;790;67;216;3232;642;1837;0;2011;2119;HOSPITAL GENERAL DE AGUDOS B. RIVADAVIA;
Cirugia;Ortopedia Y Traumatología;223;17;240;217;6;223;15;238;4390;2293;1203;628;5223;963;1979;252;2011;2119;HOSPITAL GENERAL DE AGUDOS B. RIVADAVIA;
Cirugia;Otorrinolaringología;129;4;133;129;0;129;4;133;302;300;83;82;9934;226;16075;0;2011;2119;HOSPITAL GENERAL DE AGUDOS B. RIVADAVIA;
Cirugia;Urología;263;18;281;267;0;267;14;281;4165;1195;1141;327;2869;425;2463;0;2011;2119;HOSPITAL GENERAL DE AGUDOS B. RIVADAVIA;
Cirugia;Subtotal Cirugia;2130;115;2245;2126;15;2141;109;2250;28412;11300;7784;3096;3977;502;2891;67;2011;2119;HOSPITAL GENERAL DE AGUDOS B. RIVADAVIA;
Pediatria;Recien Nacido Sano;961;224;1185;1123;0;1123;66;1189;4410;4410;1208;1208;100;371;9841;0;2011;2119;HOSPITAL GENERAL DE AGUDOS B. RIVADAVIA;
Pediatria;Neonatología;329;67;396;152;7;159;231;390;7300;4324;20;1185;5923;1109;195;179;2011;2119;HOSPITAL GENERAL DE AGUDOS B. RIVADAVIA;
Pediatria;Pediatría;546;7;553;552;0;552;1;553;5490;2128;1504;583;3876;385;3677;0;2011;2119;HOSPITAL GENERAL DE AGUDOS B. RIVADAVIA;
Pediatria;Subtotal Pediatria;1836;298;2134;1827;7;1834;298;2132;17200;10862;4712;2976;6315;509;4524;33;2011;2119;HOSPITAL GENERAL DE AGUDOS B. RIVADAVIA;
Tocoginecologia;Obstetricia;1629;10;1639;1634;0;1634;9;1643;12432;10236;3406;2804;8234;623;4824;0;2011;2119;HOSPITAL GENERAL DE AGUDOS B. RIVADAVIA;
Tocoginecologia;Subtotal Tocoginecologia;1629;10;1639;1634;0;1634;9;1643;12432;10236;3406;2804;8234;623;4824;0;2011;2119;HOSPITAL GENERAL DE AGUDOS B. RIVADAVIA;
Urgencia;Coordinacion Cuidados Intensivos;81;152;233;9;67;76;157;233;2972;2188;814;599;7362;939;2862;2876;2011;2119;HOSPITAL GENERAL DE AGUDOS B. RIVADAVIA;
Urgencia;Subtotal Urgencia;81;152;233;9;67;76;157;233;2972;2188;814;599;7362;939;2862;2876;2011;2119;HOSPITAL GENERAL DE AGUDOS B. RIVADAVIA;
Urgencia;Total Hospital;6944;943;7887;6793;173;6966;943;7909;92202;54300;25261;14877;5889;78;2758;248;2011;2119;HOSPITAL GENERAL DE AGUDOS B. RIVADAVIA;
Medicina;Cardiología;147;188;335;251;2;253;83;336;3066;1912;84;524;6236;569;40;6;2011;2121;HOSPITAL GENERAL DE AGUDOS DONACION F. SANTOJANNI;
Medicina;Clínica Médica;1096;399;1495;1144;198;1342;160;1502;22412;21639;614;5928;9655;1441;2446;1318;2011;2121;HOSPITAL GENERAL DE AGUDOS DONACION F. SANTOJANNI;
Medicina;Unidad Coronaria;416;133;549;242;30;272;278;550;2887;1868;791;512;647;34;6954;545;2011;2121;HOSPITAL GENERAL DE AGUDOS DONACION F. SANTOJANNI;
Medicina;Subtotal Medicina;1659;720;2379;1637;230;1867;521;2388;28365;25419;7771;6964;8961;1064;3073;963;2011;2121;HOSPITAL GENERAL DE AGUDOS DONACION F. SANTOJANNI;
Cirugia;Cirugía General;1173;129;1302;1232;16;1248;51;1299;9792;9030;2683;2474;9222;695;4842;123;2011;2121;HOSPITAL GENERAL DE AGUDOS DONACION F. SANTOJANNI;
Cirugia;Cirugía Cardiovascular;56;13;69;49;5;54;15;69;204;186;56;51;9118;27;12346;725;2011;2121;HOSPITAL GENERAL DE AGUDOS DONACION F. SANTOJANNI;
Cirugia;Microcirugia Y Cirugia Reparadora;316;2;318;316;0;316;2;318;564;644;155;176;11418;203;2058;0;2011;2121;HOSPITAL GENERAL DE AGUDOS DONACION F. SANTOJANNI;
Cirugia;Ginecología;711;22;733;720;1;721;11;732;3587;3229;983;885;9002;441;7449;14;2011;2121;HOSPITAL GENERAL DE AGUDOS DONACION F. SANTOJANNI;
Cirugia;Neurocirugía;197;25;222;191;5;196;23;219;3848;3491;1054;956;9072;1594;2077;228;2011;2121;HOSPITAL GENERAL DE AGUDOS DONACION F. SANTOJANNI;
Cirugia;Oftalmología;12;0;12;12;0;12;0;12;11;11;3;3;100;92;39818;0;2011;2121;HOSPITAL GENERAL DE AGUDOS DONACION F. SANTOJANNI;
Cirugia;Ortopedia Y Traumatología;592;21;613;579;11;590;26;616;8845;8371;2423;2293;9464;1359;2542;179;2011;2121;HOSPITAL GENERAL DE AGUDOS DONACION F. SANTOJANNI;
Cirugia;Otorrinolaringología;17;0;17;17;0;17;0;17;17;16;5;4;9412;94;365;0;2011;2121;HOSPITAL GENERAL DE AGUDOS DONACION F. SANTOJANNI;
Cirugia;Urología;352;16;368;361;0;361;9;370;1974;2007;541;55;10167;542;6841;0;2011;2121;HOSPITAL GENERAL DE AGUDOS DONACION F. SANTOJANNI;
Cirugia;Subtotal Cirugia;3426;228;3654;3477;38;3515;137;3652;28842;26985;7902;7393;9356;739;4622;104;2011;2121;HOSPITAL GENERAL DE AGUDOS DONACION F. SANTOJANNI;
Pediatria;Recien Nacido Sano;3987;291;4278;4250;0;4250;38;4288;21921;16055;6006;4399;7324;374;714;0;2011;2121;HOSPITAL GENERAL DE AGUDOS DONACION F. SANTOJANNI;
Pediatria;Neonatología;510;202;712;269;15;284;440;724;10657;6515;292;1785;6113;9;248;207;2011;2121;HOSPITAL GENERAL DE AGUDOS DONACION F. SANTOJANNI;
Pediatria;Pediatría;1133;5;1138;1135;0;1135;5;1140;8739;5128;2394;1405;5868;45;4761;0;2011;2121;HOSPITAL GENERAL DE AGUDOS DONACION F. SANTOJANNI;
Pediatria;Neonatologia ;24;0;24;0;3;3;19;22;300;160;82;44;5333;727;2677;1364;2011;2121;HOSPITAL GENERAL DE AGUDOS DONACION F. SANTOJANNI;
Pediatria;Subtotal Pediatria;5654;498;6152;5654;18;5672;502;6174;41617;27858;11402;7632;6694;451;5415;29;2011;2121;HOSPITAL GENERAL DE AGUDOS DONACION F. SANTOJANNI;
Tocoginecologia;Obstetricia;5109;7;5116;5107;0;5107;5;5112;23164;20691;6346;5669;8932;405;8055;0;2011;2121;HOSPITAL GENERAL DE AGUDOS DONACION F. SANTOJANNI;
Tocoginecologia;Subtotal Tocoginecologia;5109;7;5116;5107;0;5107;5;5112;23164;20691;6346;5669;8932;405;8055;0;2011;2121;HOSPITAL GENERAL DE AGUDOS DONACION F. SANTOJANNI;
Urgencia;Terapia Intermedia;17;111;128;14;16;30;97;127;2920;737;8;202;2524;58;1588;126;2011;2121;HOSPITAL GENERAL DE AGUDOS DONACION F. SANTOJANNI;
Urgencia;Terapia Intensiva;93;238;331;5;96;101;231;332;4372;2934;1198;804;6711;884;2772;2892;2011;2121;HOSPITAL GENERAL DE AGUDOS DONACION F. SANTOJANNI;
Urgencia;Reanimación y Shock;607;112;719;106;195;301;421;722;2933;1924;804;527;656;266;8985;2701;2011;2121;HOSPITAL GENERAL DE AGUDOS DONACION F. SANTOJANNI;
Urgencia;Subtotal Urgencia;717;461;1178;125;307;432;749;1181;10225;5595;2801;1533;5472;474;4216;2599;2011;2121;HOSPITAL GENERAL DE AGUDOS DONACION F. SANTOJANNI;
Urgencia;Total Hospital;16565;1914;18479;16000;593;16593;1914;18507;132213;106548;36223;29191;8059;642;4581;357;2011;2121;HOSPITAL GENERAL DE AGUDOS DONACION F. SANTOJANNI;
Medicina;Cuidados Paliativos;56;40;96;18;75;93;2;95;1460;1175;4;322;8048;1237;2375;7895;2011;2124;HOSPITAL GENERAL DE AGUDOS DR. E. TORNU;
Medicina;Clínica Médica;152;984;1136;838;99;937;197;1134;18007;15867;4933;4347;8812;1399;2299;873;2011;2124;HOSPITAL GENERAL DE AGUDOS DR. E. TORNU;
Medicina;Neumotisiología;208;226;434;354;11;365;66;431;13514;4877;3702;1336;3609;1132;1164;255;2011;2124;HOSPITAL GENERAL DE AGUDOS DR. E. TORNU;
Medicina;Subtotal Medicina;416;1250;1666;1210;185;1395;265;1660;32981;21919;9036;6005;6646;132;1837;1114;2011;2124;HOSPITAL GENERAL DE AGUDOS DR. E. TORNU;
Cirugia;Cirugía General;542;374;916;848;2;850;73;923;7696;4606;2108;1262;5985;499;4378;22;2011;2124;HOSPITAL GENERAL DE AGUDOS DR. E. TORNU;
Cirugia;Cirugía Toracica;53;52;105;82;0;82;23;105;1742;536;477;147;3077;51;22;0;2011;2124;HOSPITAL GENERAL DE AGUDOS DR. E. TORNU;
Cirugia;Ginecología;196;8;204;199;1;200;5;205;671;664;184;182;9896;324;11151;49;2011;2124;HOSPITAL GENERAL DE AGUDOS DR. E. TORNU;
Cirugia;Ortopedia Y Traumatología;26;120;146;119;3;122;28;150;3921;2149;1074;589;5481;1433;1396;2;2011;2124;HOSPITAL GENERAL DE AGUDOS DR. E. TORNU;
Cirugia;Urología;199;44;243;222;0;222;21;243;1150;1145;315;314;9957;471;7713;0;2011;2124;HOSPITAL GENERAL DE AGUDOS DR. E. TORNU;
Cirugia;Subtotal Cirugia;1016;598;1614;1470;6;1476;150;1626;15180;9100;4159;2493;5995;56;391;37;2011;2124;HOSPITAL GENERAL DE AGUDOS DR. E. TORNU;
Urgencia;Terapia Intermedia;11;177;188;104;32;136;50;186;3307;2520;906;69;762;1355;2053;172;2011;2124;HOSPITAL GENERAL DE AGUDOS DR. E. TORNU;
Urgencia;Guardia Del Día;3122;32;3154;1412;49;1461;1692;3153;2220;2141;608;587;9644;68;5184;155;2011;2124;HOSPITAL GENERAL DE AGUDOS DR. E. TORNU;
Urgencia;Terapia Intensiva;13;295;308;28;86;114;195;309;3611;2598;989;712;7195;841;3123;2783;2011;2124;HOSPITAL GENERAL DE AGUDOS DR. E. TORNU;
Urgencia;Subtotal Urgencia;3146;504;3650;1544;167;1711;1937;3648;9138;7259;2504;1989;7944;199;14571;458;2011;2124;HOSPITAL GENERAL DE AGUDOS DR. E. TORNU;
Urgencia;Total Hospital;4578;2352;6930;4224;358;4582;2352;6934;57299;38278;15698;10487;668;835;2919;781;2011;2124;HOSPITAL GENERAL DE AGUDOS DR. E. TORNU;
Medicina;Cardiología;32;44;76;68;0;68;6;74;846;682;232;187;8061;922;3193;0;2011;2120;HOSPITAL GENERAL DE AGUDOS D. VELEZ SARSFIELD;
Medicina;Clínica Médica;329;53;382;316;35;351;38;389;5188;4451;1421;1219;8579;1144;2737;9;2011;2120;HOSPITAL GENERAL DE AGUDOS D. VELEZ SARSFIELD;
Medicina;Subtotal Medicina;361;97;458;384;35;419;44;463;6034;5133;1653;1406;8507;1109;2801;756;2011;2120;HOSPITAL GENERAL DE AGUDOS D. VELEZ SARSFIELD;
Cirugia;Cirugía General;855;54;909;841;5;846;71;917;4876;4060;1336;1112;8326;443;6864;55;2011;2120;HOSPITAL GENERAL DE AGUDOS D. VELEZ SARSFIELD;
Cirugia;Ginecología;148;1;149;146;0;146;1;147;753;571;206;156;7583;388;7125;0;2011;2120;HOSPITAL GENERAL DE AGUDOS D. VELEZ SARSFIELD;
Cirugia;Oftalmología;640;;;;;;;;;;175;;;;;;2011;2120;HOSPITAL GENERAL DE AGUDOS D. VELEZ SARSFIELD;
Cirugia;Ortopedia Y Traumatología;238;16;254;225;1;226;17;243;3078;2750;843;753;8934;1132;2882;41;2011;2120;HOSPITAL GENERAL DE AGUDOS D. VELEZ SARSFIELD;
Cirugia;Subtotal Cirugia;1241;71;1312;1212;6;1218;89;1307;9347;7381;2561;2022;7897;565;5104;46;2011;2120;HOSPITAL GENERAL DE AGUDOS D. VELEZ SARSFIELD;
Pediatria;Recien Nacido Sano;950;337;1287;1184;0;1184;107;1291;6604;3464;1809;949;5245;268;7135;0;2011;2120;HOSPITAL GENERAL DE AGUDOS D. VELEZ SARSFIELD;
Pediatria;Neonatología;715;107;822;482;5;487;338;825;3240;2844;888;779;8778;345;9294;61;2011;2120;HOSPITAL GENERAL DE AGUDOS D. VELEZ SARSFIELD;
Pediatria;Pediatría;647;40;687;689;1;690;1;691;5014;2387;1374;654;4761;345;503;14;2011;2120;HOSPITAL GENERAL DE AGUDOS D. VELEZ SARSFIELD;
Pediatria;Subtotal Pediatria;2312;484;2796;2355;6;2361;446;2807;14858;8695;4071;2382;5852;31;6896;21;2011;2120;HOSPITAL GENERAL DE AGUDOS D. VELEZ SARSFIELD;
Tocoginecologia;Obstetricia;1875;11;1886;1875;0;1875;15;1890;9204;5831;2522;1598;6335;309;7495;0;2011;2120;HOSPITAL GENERAL DE AGUDOS D. VELEZ SARSFIELD;
Tocoginecologia;Subtotal Tocoginecologia;1875;11;1886;1875;0;1875;15;1890;9204;5831;2522;1598;6335;309;7495;0;2011;2120;HOSPITAL GENERAL DE AGUDOS D. VELEZ SARSFIELD;
Urgencia;Terapia Intermedia;2;0;2;0;0;0;2;2;44;6;12;2;1364;3;1659;0;2011;2120;HOSPITAL GENERAL DE AGUDOS D. VELEZ SARSFIELD;
Urgencia;Terapia Intensiva;141;76;217;8;62;70;143;213;2373;1895;65;519;7986;89;3276;2911;2011;2120;HOSPITAL GENERAL DE AGUDOS D. VELEZ SARSFIELD;
Urgencia;Subtotal Urgencia;143;76;219;8;62;70;145;215;2417;1901;662;521;7865;884;3247;2884;2011;2120;HOSPITAL GENERAL DE AGUDOS D. VELEZ SARSFIELD;
Urgencia;Total Hospital;5932;739;6671;5834;109;5943;739;6682;41860;28941;11468;7929;6914;487;5182;183;2011;2120;HOSPITAL GENERAL DE AGUDOS D. VELEZ SARSFIELD;
Medicina;Unidad Coronaria;146;45;191;114;8;122;75;197;1825;1354;5;371;7419;687;394;406;2011;2118;HOSPITAL GENERAL DE AGUDOS A. ZUBIZARRETA;
Medicina;Subtotal Medicina;146;45;191;114;8;122;75;197;1825;1354;5;371;7419;687;394;406;2011;2118;HOSPITAL GENERAL DE AGUDOS A. ZUBIZARRETA;
Pediatria;Adolescencia;56;4;60;67;0;67;4;71;2190;394;6;108;1799;555;1183;0;2011;2118;HOSPITAL GENERAL DE AGUDOS A. ZUBIZARRETA;
Pediatria;Pediatría;347;0;347;365;0;365;5;370;4380;3888;12;1065;8877;1051;3083;0;2011;2118;HOSPITAL GENERAL DE AGUDOS A. ZUBIZARRETA;
Pediatria;Subtotal Pediatria;403;4;407;432;0;432;9;441;6570;4282;18;1173;6518;971;245;0;2011;2118;HOSPITAL GENERAL DE AGUDOS A. ZUBIZARRETA;
Urgencia;Terapia Intermedia;800;443;1243;1078;30;1108;145;1253;10764;6598;2949;1808;613;527;4249;239;2011;2118;HOSPITAL GENERAL DE AGUDOS A. ZUBIZARRETA;
Urgencia;Terapia Intensiva;70;116;186;12;53;65;123;188;2190;2337;6;64;10671;1243;3133;2819;2011;2118;HOSPITAL GENERAL DE AGUDOS A. ZUBIZARRETA;
Urgencia;Subtotal Urgencia;870;559;1429;1090;83;1173;268;1441;12954;8935;3549;2448;6897;62;406;576;2011;2118;HOSPITAL GENERAL DE AGUDOS A. ZUBIZARRETA;
Area Indiferenciada;Area Indiferenciada - Cuidados Alejados;1367;69;1436;1030;106;1136;310;1446;15108;11549;4139;3164;7644;799;3493;733;2011;2118;HOSPITAL GENERAL DE AGUDOS A. ZUBIZARRETA;
Area Indiferenciada;Area Indiferenciada;127;2;129;89;13;102;17;119;1395;1024;382;281;7341;861;3114;1092;2011;2118;HOSPITAL GENERAL DE AGUDOS A. ZUBIZARRETA;
Area Indiferenciada;Subtotal Area Indiferenciada;1494;71;1565;1119;119;1238;327;1565;16503;12573;4521;3445;7619;803;3461;76;2011;2118;HOSPITAL GENERAL DE AGUDOS A. ZUBIZARRETA;
Area Indiferenciada;Total Hospital;2913;679;3592;2755;210;2965;679;3644;37852;27144;1037;7437;7171;915;2859;708;2011;2118;HOSPITAL GENERAL DE AGUDOS A. ZUBIZARRETA;
Cuidados Genereales - Area Indiferenciada;Sector 1;728;318;1046;993;2;995;59;1054;9126;6804;25;1864;7456;646;4216;19;2011;2172;HOSPITAL GENERAL DE NIÑOS PEDRO DE ELIZALDE;
Cuidados Genereales - Area Indiferenciada;Sector 2;649;250;899;833;0;833;60;893;8760;6561;24;1798;749;735;3721;0;2011;2172;HOSPITAL GENERAL DE NIÑOS PEDRO DE ELIZALDE;
Cuidados Genereales - Area Indiferenciada;Sector 3 A;250;134;384;336;0;336;51;387;4015;2693;11;738;6707;696;3518;0;2011;2172;HOSPITAL GENERAL DE NIÑOS PEDRO DE ELIZALDE;
Cuidados Genereales - Area Indiferenciada;Sector 3 B - Presión Negativa;236;106;342;280;0;280;61;341;5840;3229;16;885;5529;947;2131;0;2011;2172;HOSPITAL GENERAL DE NIÑOS PEDRO DE ELIZALDE;
Cuidados Genereales - Area Indiferenciada;Sector 4;747;261;1008;960;0;960;51;1011;9125;6664;25;1826;7303;659;4044;0;2011;2172;HOSPITAL GENERAL DE NIÑOS PEDRO DE ELIZALDE;
Cuidados Genereales - Area Indiferenciada;Sector 5;632;227;859;817;0;817;45;862;9125;6482;25;1776;7104;752;3448;0;2011;2172;HOSPITAL GENERAL DE NIÑOS PEDRO DE ELIZALDE;
Cuidados Genereales - Area Indiferenciada;Sector 6 A;349;91;440;386;3;389;57;446;5475;2477;15;679;4524;555;2973;67;2011;2172;HOSPITAL GENERAL DE NIÑOS PEDRO DE ELIZALDE;
Cuidados Genereales - Area Indiferenciada;Sector 6 B - Presión Positiva;207;49;256;224;2;226;32;258;4380;1749;12;479;3993;678;215;78;2011;2172;HOSPITAL GENERAL DE NIÑOS PEDRO DE ELIZALDE;
Cuidados Genereales - Area Indiferenciada;Sector 7;1725;118;1843;1734;0;1734;110;1844;10220;5834;28;1598;5708;316;6586;0;2011;2172;HOSPITAL GENERAL DE NIÑOS PEDRO DE ELIZALDE;
Cuidados Genereales - Area Indiferenciada;Subtotal Cuidados Genereales - Area Indiferenciada;5523;1554;7077;6563;7;6570;526;7096;66066;42493;181;11642;6432;599;392;1;2011;2172;HOSPITAL GENERAL DE NIÑOS PEDRO DE ELIZALDE;
Cuidados Especiales;Neonatología Alta Complejidad;135;36;171;31;28;59;113;172;4380;2653;12;727;6057;1542;1433;1628;2011;2172;HOSPITAL GENERAL DE NIÑOS PEDRO DE ELIZALDE;
Cuidados Especiales;Neonatología Mediana Complejidad;150;110;260;224;2;226;35;261;4416;3158;121;865;7151;121;2157;77;2011;2172;HOSPITAL GENERAL DE NIÑOS PEDRO DE ELIZALDE;
Cuidados Especiales;Cuidados Intermedios;62;186;248;44;3;47;205;252;2922;2217;801;607;7587;88;3148;119;2011;2172;HOSPITAL GENERAL DE NIÑOS PEDRO DE ELIZALDE;
Cuidados Especiales;Cuidados Intensivos;153;209;362;11;30;41;325;366;4015;2393;11;656;596;654;3327;82;2011;2172;HOSPITAL GENERAL DE NIÑOS PEDRO DE ELIZALDE;
Cuidados Especiales;Cirugía Cardiovascular;153;40;193;152;16;168;21;189;3037;1678;832;46;5525;888;2271;847;2011;2172;HOSPITAL GENERAL DE NIÑOS PEDRO DE ELIZALDE;
Cuidados Especiales;Guardia;1996;1;1997;1086;0;1086;911;1997;2938;2068;805;567;7039;104;2481;0;2011;2172;HOSPITAL GENERAL DE NIÑOS PEDRO DE ELIZALDE;
Cuidados Especiales;Subtotal Cuidados Especiales;2649;582;3231;1548;79;1627;1610;3237;21708;14167;5947;3881;6526;438;5443;244;2011;2172;HOSPITAL GENERAL DE NIÑOS PEDRO DE ELIZALDE;
Cuidados Especiales;Total Hospital;8172;2136;10308;8111;86;8197;2136;10333;87774;56660;24048;15523;6455;691;3409;105;2011;2172;HOSPITAL GENERAL DE NIÑOS PEDRO DE ELIZALDE;
Medicina;Pediatria;3133;452;3585;3175;6;3181;405;3586;34432;29681;9433;8132;862;828;3801;17;2011;2164;HOSPITAL GENERAL DE NIÑOS RICARDO GUTIERREZ;
Medicina;Endocrinología;386;0;386;386;0;386;0;386;2189;385;6;105;1759;1;6436;0;2011;2164;HOSPITAL GENERAL DE NIÑOS RICARDO GUTIERREZ;
Medicina;Infecciosas;658;146;804;674;7;681;119;800;9914;7129;2716;1953;7191;891;2945;88;2011;2164;HOSPITAL GENERAL DE NIÑOS RICARDO GUTIERREZ;
Medicina;Neonatología;289;15;304;264;22;286;19;305;6761;5400;1852;1479;7987;177;1647;721;2011;2164;HOSPITAL GENERAL DE NIÑOS RICARDO GUTIERREZ;
Medicina;Centro Respiratorio;199;94;293;203;0;203;100;303;3823;2782;1047;762;7277;918;2893;0;2011;2164;HOSPITAL GENERAL DE NIÑOS RICARDO GUTIERREZ;
Medicina;Nefrología;322;15;337;312;0;312;30;342;4380;2477;12;679;5655;724;285;0;2011;2164;HOSPITAL GENERAL DE NIÑOS RICARDO GUTIERREZ;
Medicina;Subtotal Medicina;4987;722;5709;5014;35;5049;673;5722;61499;47854;16849;13111;7781;836;3396;61;2011;2164;HOSPITAL GENERAL DE NIÑOS RICARDO GUTIERREZ;
Cirugia;Cirugía General;1978;383;2361;1943;5;1948;408;2356;12789;7740;3504;2121;6052;329;6724;21;2011;2164;HOSPITAL GENERAL DE NIÑOS RICARDO GUTIERREZ;
Cirugia;Cirugía Cardiovascular;250;27;277;249;22;271;10;281;7300;4182;20;1146;5729;1488;1405;783;2011;2164;HOSPITAL GENERAL DE NIÑOS RICARDO GUTIERREZ;
Cirugia;Cirugía Plástica Y Reparadora - niÃ±os;448;21;469;447;0;447;22;469;3263;1765;894;484;5409;376;5246;0;2011;2164;HOSPITAL GENERAL DE NIÑOS RICARDO GUTIERREZ;
Cirugia;Neurocirugía;437;79;516;442;0;442;70;512;7461;3285;2044;9;4403;642;2505;0;2011;2164;HOSPITAL GENERAL DE NIÑOS RICARDO GUTIERREZ;
Cirugia;Ortopedia Y Traumatología;1244;103;1347;1216;0;1216;132;1348;12998;7535;3561;2064;5797;559;3785;0;2011;2164;HOSPITAL GENERAL DE NIÑOS RICARDO GUTIERREZ;
Pediatria;Pediatría;1121;4;1125;1123;1;1124;3;1127;9326;5435;2548;1485;5828;482;4423;9;2012;2121;HOSPITAL GENERAL DE AGUDOS DONACION F. SANTOJANNI;
Pediatria;Neonatologia ;11;2;13;3;0;3;13;16;310;177;85;48;571;1106;1889;0;2012;2121;HOSPITAL GENERAL DE AGUDOS DONACION F. SANTOJANNI;
Pediatria;Subtotal Pediatria;5245;421;5666;5223;34;5257;414;5671;42266;27101;11548;7405;6412;478;4911;6;2012;2121;HOSPITAL GENERAL DE AGUDOS DONACION F. SANTOJANNI;
Tocoginecologia;Obstetricia;4634;6;4640;4652;1;4653;4;4657;23542;20427;6432;5581;8677;439;724;2;2012;2121;HOSPITAL GENERAL DE AGUDOS DONACION F. SANTOJANNI;
Tocoginecologia;Subtotal Tocoginecologia;4634;6;4640;4652;1;4653;4;4657;23542;20427;6432;5581;8677;439;724;2;2012;2121;HOSPITAL GENERAL DE AGUDOS DONACION F. SANTOJANNI;
Urgencia;Terapia Intermedia;24;98;122;21;7;28;95;123;2928;801;8;219;2736;651;1538;569;2012;2121;HOSPITAL GENERAL DE AGUDOS DONACION F. SANTOJANNI;
Urgencia;Terapia Intensiva;184;184;368;10;109;119;247;366;4392;2989;12;817;6806;817;305;2978;2012;2121;HOSPITAL GENERAL DE AGUDOS DONACION F. SANTOJANNI;
Urgencia;Observación ;624;129;753;156;197;353;400;753;2928;1830;8;5;625;243;9413;2616;2012;2121;HOSPITAL GENERAL DE AGUDOS DONACION F. SANTOJANNI;
Urgencia;Subtotal Urgencia;832;411;1243;187;313;500;742;1242;10248;5620;28;1536;5484;452;4436;252;2012;2121;HOSPITAL GENERAL DE AGUDOS DONACION F. SANTOJANNI;
Urgencia;Total Hospital;15577;1850;17427;14940;669;15609;1850;17459;129308;101868;3533;27833;7878;653;4418;429;2012;2121;HOSPITAL GENERAL DE AGUDOS DONACION F. SANTOJANNI;
Medicina;Cuidados Paliativos;100;47;147;70;74;144;4;148;1426;1242;39;339;871;839;3799;50;2012;2124;HOSPITAL GENERAL DE AGUDOS DR. E. TORNU;
Medicina;Clínica Médica;431;1024;1455;1158;97;1255;202;1457;17316;14868;4731;4062;8586;102;308;666;2012;2124;HOSPITAL GENERAL DE AGUDOS DR. E. TORNU;
Medicina;Neumotisiología;207;257;464;385;9;394;75;469;13912;4377;3801;1196;3146;933;1234;192;2012;2124;HOSPITAL GENERAL DE AGUDOS DR. E. TORNU;
Medicina;Subtotal Medicina;738;1328;2066;1613;180;1793;281;2074;32654;20487;8922;5598;6274;988;2325;868;2012;2124;HOSPITAL GENERAL DE AGUDOS DR. E. TORNU;
Cirugia;Cirugía General;599;370;969;881;2;883;75;958;8323;5119;2274;1399;615;534;4213;21;2012;2124;HOSPITAL GENERAL DE AGUDOS DR. E. TORNU;
Cirugia;Cirugía Toracica;53;58;111;88;0;88;22;110;2084;675;569;184;3239;614;1932;0;2012;2124;HOSPITAL GENERAL DE AGUDOS DR. E. TORNU;
Cirugia;Ginecología;181;6;187;182;0;182;5;187;561;561;153;153;100;3;122;0;2012;2124;HOSPITAL GENERAL DE AGUDOS DR. E. TORNU;
Cirugia;Ortopedia Y Traumatología;71;129;200;159;0;159;34;193;4291;2334;1172;638;5439;1209;1646;0;2012;2124;HOSPITAL GENERAL DE AGUDOS DR. E. TORNU;
Cirugia;Urología;209;30;239;226;0;226;13;239;977;977;267;267;100;409;8953;0;2012;2124;HOSPITAL GENERAL DE AGUDOS DR. E. TORNU;
Cirugia;Subtotal Cirugia;1113;593;1706;1536;2;1538;149;1687;16236;9666;4436;2641;5953;573;3803;12;2012;2124;HOSPITAL GENERAL DE AGUDOS DR. E. TORNU;
Urgencia;Terapia Intermedia;12;203;215;134;26;160;54;214;3113;2584;851;706;8301;1207;2516;1215;2012;2124;HOSPITAL GENERAL DE AGUDOS DR. E. TORNU;
Urgencia;Guardia Del Día;3340;48;3388;1539;61;1600;1789;3389;2212;2091;604;571;9453;62;56075;18;2012;2124;HOSPITAL GENERAL DE AGUDOS DR. E. TORNU;
Urgencia;Terapia Intensiva;17;267;284;29;91;120;166;286;3657;2393;999;654;6544;837;2862;3182;2012;2124;HOSPITAL GENERAL DE AGUDOS DR. E. TORNU;
Urgencia;Subtotal Urgencia;3369;518;3887;1702;178;1880;2009;3889;8982;7068;2454;1931;7869;182;15847;458;2012;2124;HOSPITAL GENERAL DE AGUDOS DR. E. TORNU;
Urgencia;Total Hospital;5220;2439;7659;4851;360;5211;2439;7650;57872;37221;15812;1017;6432;714;3296;691;2012;2124;HOSPITAL GENERAL DE AGUDOS DR. E. TORNU;
Medicina;Cardiología;26;27;53;47;0;47;7;54;1023;868;28;237;8485;1607;1932;0;2012;2120;HOSPITAL GENERAL DE AGUDOS D. VELEZ SARSFIELD;
Medicina;Clínica Médica;315;41;356;279;32;311;32;343;5253;4741;1435;1295;9025;1382;239;933;2012;2120;HOSPITAL GENERAL DE AGUDOS D. VELEZ SARSFIELD;
Medicina;Subtotal Medicina;341;68;409;326;32;358;39;397;6276;5609;1715;1533;8937;1413;2315;806;2012;2120;HOSPITAL GENERAL DE AGUDOS D. VELEZ SARSFIELD;
Cirugia;Cirugía General;707;35;742;688;5;693;42;735;4453;3830;1217;1046;8601;521;6041;68;2012;2120;HOSPITAL GENERAL DE AGUDOS D. VELEZ SARSFIELD;
Cirugia;Ginecología;138;6;144;144;0;144;1;145;883;682;241;186;7724;47;601;0;2012;2120;HOSPITAL GENERAL DE AGUDOS D. VELEZ SARSFIELD;
Cirugia;Oftalmología;0;0;0;0;0;0;0;0;527;0;0;0;0;0;0;0;2012;2120;HOSPITAL GENERAL DE AGUDOS D. VELEZ SARSFIELD;
Cirugia;Ortopedia Y Traumatología;262;24;286;273;2;275;21;296;3846;3628;1051;991;9433;1226;2817;68;2012;2120;HOSPITAL GENERAL DE AGUDOS D. VELEZ SARSFIELD;
Cirugia;Subtotal Cirugia;1107;65;1172;1105;7;1112;64;1176;9709;8140;2653;2224;8384;692;4433;6;2012;2120;HOSPITAL GENERAL DE AGUDOS D. VELEZ SARSFIELD;
Pediatria;Recien Nacido Sano;925;365;1290;1113;0;1113;180;1293;6491;3638;1773;994;5605;281;7291;0;2012;2120;HOSPITAL GENERAL DE AGUDOS D. VELEZ SARSFIELD;
Pediatria;Neonatología;712;180;892;519;8;527;366;893;3430;3067;937;838;8942;343;9529;9;2012;2120;HOSPITAL GENERAL DE AGUDOS D. VELEZ SARSFIELD;
Pediatria;Pediatría;595;12;607;597;0;597;3;600;5016;2507;137;685;4998;418;4378;0;2012;2120;HOSPITAL GENERAL DE AGUDOS D. VELEZ SARSFIELD;
Pediatria;Subtotal Pediatria;2232;557;2789;2229;8;2237;549;2786;14937;9212;4081;2517;6167;331;6827;29;2012;2120;HOSPITAL GENERAL DE AGUDOS D. VELEZ SARSFIELD;
Tocoginecologia;Obstetricia;1838;5;1843;1842;0;1842;10;1852;8790;6080;2402;1661;6917;328;7711;0;2012;2120;HOSPITAL GENERAL DE AGUDOS D. VELEZ SARSFIELD;
Urgencia;Terapia Intensiva;86;71;157;16;36;52;104;156;1942;1800;531;492;9269;1154;294;2308;2012;2120;HOSPITAL GENERAL DE AGUDOS D. VELEZ SARSFIELD;
Urgencia;Subtotal Urgencia;86;71;157;16;36;52;104;156;1942;1800;531;492;9269;1154;294;2308;2012;2120;HOSPITAL GENERAL DE AGUDOS D. VELEZ SARSFIELD;
Urgencia;Total Hospital;5604;766;6370;5518;83;5601;766;6367;41654;30841;11381;8427;7404;551;4921;148;2012;2120;HOSPITAL GENERAL DE AGUDOS D. VELEZ SARSFIELD;
Medicina;Unidad Coronaria;112;55;167;79;8;87;76;163;1640;1255;448;343;7652;77;3638;491;2012;2118;HOSPITAL GENERAL DE AGUDOS A. ZUBIZARRETA;
Medicina;Subtotal Medicina;112;55;167;79;8;87;76;163;1640;1255;448;343;7652;77;3638;491;2012;2118;HOSPITAL GENERAL DE AGUDOS A. ZUBIZARRETA;
Pediatria;Adolescencia;31;11;42;43;0;43;1;44;1618;308;442;84;1904;7;995;0;2012;2118;HOSPITAL GENERAL DE AGUDOS A. ZUBIZARRETA;
Pediatria;Pediatría;433;0;433;453;0;453;0;453;4970;4205;1358;1149;8461;928;3336;0;2012;2118;HOSPITAL GENERAL DE AGUDOS A. ZUBIZARRETA;
Pediatria;Subtotal Pediatria;464;11;475;496;0;496;1;497;6588;4513;18;1233;685;908;2761;0;2012;2118;HOSPITAL GENERAL DE AGUDOS A. ZUBIZARRETA;
Urgencia;Terapia Intermedia;788;395;1183;1038;24;1062;116;1178;10980;6536;30;1786;5953;555;3927;204;2012;2118;HOSPITAL GENERAL DE AGUDOS A. ZUBIZARRETA;
Urgencia;Terapia Intensiva;82;121;203;14;59;73;132;205;2196;1601;6;437;7291;781;3417;2878;2012;2118;HOSPITAL GENERAL DE AGUDOS A. ZUBIZARRETA;
Urgencia;Subtotal Urgencia;870;516;1386;1052;83;1135;248;1383;13176;8137;36;2223;6176;588;3842;6;2012;2118;HOSPITAL GENERAL DE AGUDOS A. ZUBIZARRETA;
Area Indiferenciada;Area Indiferenciada - Cuidados Alejados;1488;86;1574;1090;128;1218;343;1561;16102;13831;4399;3779;859;886;3548;82;2012;2118;HOSPITAL GENERAL DE AGUDOS A. ZUBIZARRETA;
Area Indiferenciada;Subtotal Area Indiferenciada;1488;86;1574;1090;128;1218;343;1561;16102;13831;4399;3779;859;886;3548;82;2012;2118;HOSPITAL GENERAL DE AGUDOS A. ZUBIZARRETA;
Area Indiferenciada;Total Hospital;2934;668;3602;2717;219;2936;668;3604;37506;27736;10248;7578;7395;945;2865;746;2012;2118;HOSPITAL GENERAL DE AGUDOS A. ZUBIZARRETA;
Cuidados Genereales - Area Indiferenciada;Sector 1;808;259;1067;1007;0;1007;60;1067;9150;6998;25;1912;7648;656;4268;0;2012;2172;HOSPITAL GENERAL DE NIÑOS PEDRO DE ELIZALDE;
Cuidados Genereales - Area Indiferenciada;Sector 2;681;190;871;832;0;832;42;874;8784;6464;24;1766;7359;74;3642;0;2012;2172;HOSPITAL GENERAL DE NIÑOS PEDRO DE ELIZALDE;
Cuidados Genereales - Area Indiferenciada;Sector 3 A;290;120;410;373;1;374;35;409;4026;2798;11;764;695;684;3718;24;2012;2172;HOSPITAL GENERAL DE NIÑOS PEDRO DE ELIZALDE;
Cuidados Genereales - Area Indiferenciada;Sector 3 B - Presión Negativa;244;104;348;281;0;281;67;348;5856;3054;16;834;5215;878;2175;0;2012;2172;HOSPITAL GENERAL DE NIÑOS PEDRO DE ELIZALDE;
Cuidados Genereales - Area Indiferenciada;Sector 4;847;195;1042;999;1;1000;48;1048;9154;6757;2501;1846;7381;645;419;1;2012;2172;HOSPITAL GENERAL DE NIÑOS PEDRO DE ELIZALDE;
Cuidados Genereales - Area Indiferenciada;Sector 5;743;216;959;905;0;905;54;959;9150;6339;25;1732;6928;661;3836;0;2012;2172;HOSPITAL GENERAL DE NIÑOS PEDRO DE ELIZALDE;
Cuidados Genereales - Area Indiferenciada;Sector 6 A;436;82;518;461;0;461;54;515;5490;2608;15;713;475;506;3433;0;2012;2172;HOSPITAL GENERAL DE NIÑOS PEDRO DE ELIZALDE;
Cuidados Genereales - Area Indiferenciada;Sector 6 B - Presión Positiva;207;56;263;222;0;222;40;262;4392;1553;12;424;3536;593;2183;0;2012;2172;HOSPITAL GENERAL DE NIÑOS PEDRO DE ELIZALDE;
Cuidados Genereales - Area Indiferenciada;Sector 7;2154;111;2265;2147;0;2147;111;2258;10248;6763;28;1848;6599;3;8064;0;2012;2172;HOSPITAL GENERAL DE NIÑOS PEDRO DE ELIZALDE;
Cuidados Genereales - Area Indiferenciada;Subtotal Cuidados Genereales - Area Indiferenciada;6410;1333;7743;7227;2;7229;511;7740;66250;43334;18101;1184;6541;56;4276;3;2012;2172;HOSPITAL GENERAL DE NIÑOS PEDRO DE ELIZALDE;
Cuidados Especiales;Neonatología Alta Complejidad;118;32;150;20;23;43;105;148;4392;2675;12;731;6091;1807;1233;1554;2012;2172;HOSPITAL GENERAL DE NIÑOS PEDRO DE ELIZALDE;
Cuidados Especiales;Neonatología Mediana Complejidad;195;96;291;258;0;258;29;287;4398;2955;1202;807;6719;103;2388;0;2012;2172;HOSPITAL GENERAL DE NIÑOS PEDRO DE ELIZALDE;
Tocoginecologia;Subtotal Tocoginecologia;3093;22;3115;3075;1;3076;39;3115;13571;10543;3708;2881;7769;338;8401;3;2012;2122;HOSPITAL GENERAL DE AGUDOS DR C. ARGERICH;
Urgencia;Guardia Del Día;1324;15;1339;722;151;873;464;1337;6294;6294;172;172;100;471;7775;1129;2012;2122;HOSPITAL GENERAL DE AGUDOS DR C. ARGERICH;
Urgencia;Terapia Intensiva;241;546;787;87;148;235;557;792;7504;6411;205;1752;8543;809;3863;1869;2012;2122;HOSPITAL GENERAL DE AGUDOS DR C. ARGERICH;
Urgencia;Subtotal Urgencia;1565;561;2126;809;299;1108;1021;2129;13798;12705;377;3471;9208;597;5647;1404;2012;2122;HOSPITAL GENERAL DE AGUDOS DR C. ARGERICH;
Urgencia;Total Hospital;13756;2680;16436;13263;500;13763;2680;16443;140189;101567;38303;27751;7245;738;3593;363;2012;2122;HOSPITAL GENERAL DE AGUDOS DR C. ARGERICH;
Medicina;Cardiología;55;294;349;243;7;250;105;355;8634;3395;2359;928;3932;956;1505;197;2012;2123;HOSPITAL GENERAL DE AGUDOS DR. C. DURAND;
Medicina;Clínica Médica;961;330;1291;1065;97;1162;135;1297;19898;16658;5437;4551;8372;1284;2386;748;2012;2123;HOSPITAL GENERAL DE AGUDOS DR. C. DURAND;
Medicina;Geriatría;189;116;305;203;75;278;32;310;8470;6861;2314;1875;81;2213;134;2419;2012;2123;HOSPITAL GENERAL DE AGUDOS DR. C. DURAND;
Medicina;Unidad Coronaria;321;100;421;133;30;163;256;419;4026;2183;11;596;5422;521;3809;716;2012;2123;HOSPITAL GENERAL DE AGUDOS DR. C. DURAND;
Medicina;Subtotal Medicina;1526;840;2366;1644;209;1853;528;2381;41028;29097;1121;795;7092;1222;2124;878;2012;2123;HOSPITAL GENERAL DE AGUDOS DR. C. DURAND;
Cirugia;Cirugía General;773;145;918;798;3;801;119;920;4103;4119;1121;1125;10039;448;8207;33;2012;2123;HOSPITAL GENERAL DE AGUDOS DR. C. DURAND;
Cirugia;Cirugía Cardiovascular;78;77;155;39;13;52;103;155;1404;897;384;245;6389;579;4041;839;2012;2123;HOSPITAL GENERAL DE AGUDOS DR. C. DURAND;
Cirugia;Cirugía Plástica Y Reparadora - niÃ±os;22;2;24;24;0;24;0;24;75;75;2;2;100;313;11712;0;2012;2123;HOSPITAL GENERAL DE AGUDOS DR. C. DURAND;
Cirugia;Oftalmología;2;0;2;2;0;2;0;2;4;4;1;1;100;2;183;0;2012;2123;HOSPITAL GENERAL DE AGUDOS DR. C. DURAND;
Cirugia;Ortopedia Y Traumatología;358;33;391;352;4;356;33;389;3606;3605;985;985;9997;927;3948;103;2012;2123;HOSPITAL GENERAL DE AGUDOS DR. C. DURAND;
Cirugia;Otorrinolaringología;75;4;79;80;0;80;1;81;374;374;102;102;100;462;7927;0;2012;2123;HOSPITAL GENERAL DE AGUDOS DR. C. DURAND;
Cirugia;Urología;350;34;384;358;0;358;31;389;1209;1209;33;33;100;311;11776;0;2012;2123;HOSPITAL GENERAL DE AGUDOS DR. C. DURAND;
Cirugia;Vascular Periférico;47;34;81;54;0;54;28;82;647;641;177;175;9907;782;4639;0;2012;2123;HOSPITAL GENERAL DE AGUDOS DR. C. DURAND;
Cirugia;Subtotal Cirugia;1705;329;2034;1707;20;1727;315;2042;11422;10924;3121;2985;9564;535;6543;98;2012;2123;HOSPITAL GENERAL DE AGUDOS DR. C. DURAND;
Pediatria;Recien Nacido Sano;1471;162;1633;1594;0;1594;35;1629;9164;5609;2504;1533;6121;344;6506;0;2012;2123;HOSPITAL GENERAL DE AGUDOS DR. C. DURAND;
Pediatria;Neonatología;430;193;623;296;16;312;319;631;7336;5214;2004;1425;7107;826;3148;254;2012;2123;HOSPITAL GENERAL DE AGUDOS DR. C. DURAND;
Pediatria;Pediatría;1015;33;1048;965;0;965;86;1051;10965;4682;2996;1279;427;445;3508;0;2012;2123;HOSPITAL GENERAL DE AGUDOS DR. C. DURAND;
Pediatria;Subtotal Pediatria;2916;388;3304;2855;16;2871;440;3311;27465;15505;7504;4236;5645;468;4412;48;2012;2123;HOSPITAL GENERAL DE AGUDOS DR. C. DURAND;
Tocoginecologia;Tocoginecología;2850;49;2899;2838;3;2841;49;2890;19004;12573;5192;3435;6616;435;5566;1;2012;2123;HOSPITAL GENERAL DE AGUDOS DR. C. DURAND;
Tocoginecologia;Subtotal Tocoginecologia;2850;49;2899;2838;3;2841;49;2890;19004;12573;5192;3435;6616;435;5566;1;2012;2123;HOSPITAL GENERAL DE AGUDOS DR. C. DURAND;
Urgencia;Terapia Intermedia;80;83;163;128;2;130;32;162;2656;1299;726;355;4891;802;2232;123;2012;2123;HOSPITAL GENERAL DE AGUDOS DR. C. DURAND;
Urgencia;Guardia Del Día;518;9;527;166;54;220;312;532;3658;2124;999;58;5806;399;5323;1015;2012;2123;HOSPITAL GENERAL DE AGUDOS DR. C. DURAND;
Urgencia;Terapia Intensiva;170;308;478;33;107;140;329;469;4737;3635;1294;993;7674;775;3624;2281;2012;2123;HOSPITAL GENERAL DE AGUDOS DR. C. DURAND;
Urgencia;Subtotal Urgencia;768;400;1168;327;163;490;673;1163;11051;7058;3019;1928;6387;607;3852;1402;2012;2123;HOSPITAL GENERAL DE AGUDOS DR. C. DURAND;
Urgencia;Total Hospital;9765;2006;11771;9371;411;9782;2005;11787;109970;75157;30046;20535;6834;768;3256;42;2012;2123;HOSPITAL GENERAL DE AGUDOS DR. C. DURAND;
Medicina;Cardiología;112;186;298;209;5;214;83;297;2928;1696;8;463;5792;571;3713;168;2012;2127;HOSPITAL GENERAL DE AGUDOS DR. J. A. FERNANDEZ;
Medicina;Clínica Médica;1136;429;1565;1188;136;1324;249;1573;28840;25548;788;698;8859;1624;1996;865;2012;2127;HOSPITAL GENERAL DE AGUDOS DR. J. A. FERNANDEZ;
Medicina;Unidad Coronaria;454;78;532;286;39;325;207;532;3660;2122;10;58;5798;399;532;733;2012;2127;HOSPITAL GENERAL DE AGUDOS DR. J. A. FERNANDEZ;
Medicina;Subtotal Medicina;1702;693;2395;1683;180;1863;539;2402;35428;29366;968;8023;8289;1223;2481;749;2012;2127;HOSPITAL GENERAL DE AGUDOS DR. J. A. FERNANDEZ;
Cirugia;Cirugía General;972;200;1172;970;20;990;199;1189;16111;14054;4402;384;8723;1182;2701;168;2012;2127;HOSPITAL GENERAL DE AGUDOS DR. J. A. FERNANDEZ;
Cirugia;Ginecología;656;356;1012;871;8;879;128;1007;7320;4858;20;1327;6637;482;5035;79;2012;2127;HOSPITAL GENERAL DE AGUDOS DR. J. A. FERNANDEZ;
Cirugia;Neurocirugía;141;111;252;175;3;178;75;253;4347;3944;1188;1078;9073;1559;213;119;2012;2127;HOSPITAL GENERAL DE AGUDOS DR. J. A. FERNANDEZ;
Cirugia;Ortopedia Y Traumatología;936;155;1091;941;4;945;133;1078;17403;13570;4755;3708;7798;1259;2267;37;2012;2127;HOSPITAL GENERAL DE AGUDOS DR. J. A. FERNANDEZ;
Cirugia;Urología;227;22;249;217;1;218;32;250;3640;3252;995;889;8934;1301;2514;4;2012;2127;HOSPITAL GENERAL DE AGUDOS DR. J. A. FERNANDEZ;
Cirugia;Subtotal Cirugia;2932;844;3776;3174;36;3210;567;3777;48821;39678;13339;10841;8127;1051;2832;95;2012;2127;HOSPITAL GENERAL DE AGUDOS DR. J. A. FERNANDEZ;
Pediatria;Recien Nacido Sano;1660;34;1694;1583;0;1583;120;1703;10198;5194;2786;1419;5093;305;6112;0;2012;2127;HOSPITAL GENERAL DE AGUDOS DR. J. A. FERNANDEZ;
Pediatria;Neonatología;375;120;495;459;11;470;37;507;8102;6265;2214;1712;7733;1236;229;217;2012;2127;HOSPITAL GENERAL DE AGUDOS DR. J. A. FERNANDEZ;
Pediatria;Pediatría;696;4;700;693;0;693;1;694;7010;3417;1915;934;4874;492;3623;0;2012;2127;HOSPITAL GENERAL DE AGUDOS DR. J. A. FERNANDEZ;
Pediatria;Subtotal Pediatria;2731;158;2889;2735;11;2746;158;2904;25310;14876;6915;4064;5878;512;4199;38;2012;2127;HOSPITAL GENERAL DE AGUDOS DR. J. A. FERNANDEZ;
Tocoginecologia;Obstetricia;2444;17;2461;2112;0;2112;358;2470;10998;8129;3005;2221;7391;329;822;0;2012;2127;HOSPITAL GENERAL DE AGUDOS DR. J. A. FERNANDEZ;
Tocoginecologia;Subtotal Tocoginecologia;2444;17;2461;2112;0;2112;358;2470;10998;8129;3005;2221;7391;329;822;0;2012;2127;HOSPITAL GENERAL DE AGUDOS DR. J. A. FERNANDEZ;
Urgencia;Terapia Intermedia;38;255;293;35;17;52;242;294;4262;3963;1164;1083;9298;1348;2525;578;2012;2127;HOSPITAL GENERAL DE AGUDOS DR. J. A. FERNANDEZ;
Urgencia;Toxicología;211;11;222;217;0;217;8;225;2928;1388;8;379;474;617;2813;0;2012;2127;HOSPITAL GENERAL DE AGUDOS DR. J. A. FERNANDEZ;
Urgencia;Terapia Intensiva;224;307;531;10;109;119;413;532;6098;5250;1666;1434;8609;987;3193;2049;2012;2127;HOSPITAL GENERAL DE AGUDOS DR. J. A. FERNANDEZ;
Urgencia;Subtotal Urgencia;473;573;1046;262;126;388;663;1051;13288;10601;3631;2896;7978;1009;2895;1199;2012;2127;HOSPITAL GENERAL DE AGUDOS DR. J. A. FERNANDEZ;
Urgencia;Total Hospital;10282;2285;12567;9966;353;10319;2285;12604;133845;102650;3657;28046;7669;995;2822;342;2012;2127;HOSPITAL GENERAL DE AGUDOS DR. J. A. FERNANDEZ;
Medicina;Clínica Médica;11;590;601;478;78;556;48;604;17478;15914;4775;4348;9105;2635;1265;1291;2012;2161;HOSPITAL GENERAL DE AGUDOS J. A. PENNA;
Cirugia;Cirugía General;738;622;1360;1262;11;1273;82;1355;13210;7709;3609;2106;5836;569;3754;81;2012;2161;HOSPITAL GENERAL DE AGUDOS J. A. PENNA;
Cirugia;Ortopedia Y Traumatología;34;294;328;314;3;317;13;330;6418;5183;1754;1416;8076;1571;1882;91;2012;2161;HOSPITAL GENERAL DE AGUDOS J. A. PENNA;
Cirugia;Urología;46;257;303;280;1;281;24;305;2105;1904;575;52;9045;624;5303;33;2012;2161;HOSPITAL GENERAL DE AGUDOS J. A. PENNA;
Cirugia;Subtotal Cirugia;818;1173;1991;1856;15;1871;119;1990;21733;14796;5938;4043;6808;744;3351;75;2012;2161;HOSPITAL GENERAL DE AGUDOS J. A. PENNA;
Pediatria;Recien Nacido Sano;2970;445;3415;3195;0;3195;214;3409;17836;13382;4873;3656;7503;393;6995;0;2012;2161;HOSPITAL GENERAL DE AGUDOS J. A. PENNA;
Pediatria;Neonatología;655;176;831;404;22;426;414;840;8450;6203;2309;1695;7341;738;3638;262;2012;2161;HOSPITAL GENERAL DE AGUDOS J. A. PENNA;
Pediatria;Pediatría;855;12;867;863;0;863;2;865;4529;4457;1237;1218;9841;515;699;0;2012;2161;HOSPITAL GENERAL DE AGUDOS J. A. PENNA;
Pediatria;Subtotal Pediatria;4480;633;5113;4462;22;4484;630;5114;30815;24042;8419;6569;7802;47;6074;43;2012;2161;HOSPITAL GENERAL DE AGUDOS J. A. PENNA;
Tocoginecologia;Tocoginecología;5627;284;5911;5622;9;5631;283;5914;25564;23069;6985;6303;9024;39;8467;15;2012;2161;HOSPITAL GENERAL DE AGUDOS J. A. PENNA;
Tocoginecologia;Subtotal Tocoginecologia;5627;284;5911;5622;9;5631;283;5914;25564;23069;6985;6303;9024;39;8467;15;2012;2161;HOSPITAL GENERAL DE AGUDOS J. A. PENNA;
Urgencia;Terapia Intermedia;2;124;126;11;5;16;109;125;817;734;223;201;8984;587;56;4;2012;2161;HOSPITAL GENERAL DE AGUDOS J. A. PENNA;
Urgencia;Terapia Intensiva;2;245;247;8;73;81;166;247;2543;2432;695;664;9564;985;3555;2955;2012;2161;HOSPITAL GENERAL DE AGUDOS J. A. PENNA;
Urgencia;Subtotal Urgencia;3074;369;3443;1241;219;1460;1969;3429;9610;9418;2626;2573;98;275;13059;639;2012;2161;HOSPITAL GENERAL DE AGUDOS J. A. PENNA;
Urgencia;Total Hospital;14010;3049;17059;13659;343;14002;3049;17051;105200;87239;28743;23836;8293;623;4871;245;2012;2161;HOSPITAL GENERAL DE AGUDOS J. A. PENNA;
Medicina;Psicopatologia Y Salud Mental;229;81;310;302;0;302;7;309;7320;5026;20;1373;6866;1627;1545;0;2012;2163;HOSPITAL GENERAL DE AGUDOS P. PIÑERO;
Medicina;Subtotal Medicina;229;81;310;302;0;302;7;309;7320;5026;20;1373;6866;1627;1545;0;2012;2163;HOSPITAL GENERAL DE AGUDOS P. PIÑERO;
Cirugia;Ginecología;445;22;467;430;9;439;31;470;4396;1996;1201;545;454;425;3913;191;2012;2163;HOSPITAL GENERAL DE AGUDOS P. PIÑERO;
Cirugia;Subtotal Cirugia;445;22;467;430;9;439;31;470;4396;1996;1201;545;454;425;3913;191;2012;2163;HOSPITAL GENERAL DE AGUDOS P. PIÑERO;
Pediatria;Neonatología;74;326;400;388;11;399;8;407;6591;3849;1801;1052;584;946;226;27;2012;2163;HOSPITAL GENERAL DE AGUDOS P. PIÑERO;
Pediatria;Pediatría;1452;12;1464;1460;2;1462;2;1464;8784;4548;24;1243;5178;311;61;14;2012;2163;HOSPITAL GENERAL DE AGUDOS P. PIÑERO;
Pediatria;Subtotal Pediatria;4020;338;4358;4019;13;4032;336;4368;24952;15912;6817;4348;6377;364;6407;3;2012;2163;HOSPITAL GENERAL DE AGUDOS P. PIÑERO;
Tocoginecologia;Obstetricia;3445;41;3486;3442;0;3442;47;3489;22331;12629;6101;3451;5655;362;5718;0;2012;2163;HOSPITAL GENERAL DE AGUDOS P. PIÑERO;
Tocoginecologia;Subtotal Tocoginecologia;3445;41;3486;3442;0;3442;47;3489;22331;12629;6101;3451;5655;362;5718;0;2012;2163;HOSPITAL GENERAL DE AGUDOS P. PIÑERO;
Urgencia;Guardia Del Día;3498;51;3549;1293;176;1469;2084;3553;4325;4230;1182;1156;978;119;30067;495;2012;2163;HOSPITAL GENERAL DE AGUDOS P. PIÑERO;
Urgencia;Terapia Intensiva;3;228;231;18;65;83;147;230;2928;2110;8;577;7206;917;2875;2826;2012;2163;HOSPITAL GENERAL DE AGUDOS P. PIÑERO;
Urgencia;Subtotal Urgencia;3501;279;3780;1311;241;1552;2231;3783;7253;6340;1982;1732;8741;168;1909;637;2012;2163;HOSPITAL GENERAL DE AGUDOS P. PIÑERO;
Area Indiferenciada;Area Indiferenciada;806;2174;2980;2508;171;2679;283;2962;53048;38109;14494;10412;7184;1287;2044;577;2012;2163;HOSPITAL GENERAL DE AGUDOS P. PIÑERO;
Area Indiferenciada;Subtotal Area Indiferenciada;806;2174;2980;2508;171;2679;283;2962;53048;38109;14494;10412;7184;1287;2044;577;2012;2163;HOSPITAL GENERAL DE AGUDOS P. PIÑERO;
Area Indiferenciada;Total Hospital;12446;2935;15381;12012;434;12446;2935;15381;119300;80012;32596;21861;6707;643;3818;349;2012;2163;HOSPITAL GENERAL DE AGUDOS P. PIÑERO;
Medicina;Cardiología;0;141;141;120;0;120;22;142;2196;964;6;263;439;679;2367;0;2012;2125;HOSPITAL GENERAL DE AGUDOS DR. I. PIROVANO;
Medicina;Clínica Médica;1331;360;1691;1280;219;1499;191;1690;23442;20633;6405;5637;8802;1221;2639;1296;2012;2125;HOSPITAL GENERAL DE AGUDOS DR. I. PIROVANO;
Medicina;Unidad Coronaria;242;50;292;110;12;122;170;292;2196;1946;6;532;8862;666;4867;411;2012;2125;HOSPITAL GENERAL DE AGUDOS DR. I. PIROVANO;
Medicina;Subtotal Medicina;1573;551;2124;1510;231;1741;383;2124;27834;23543;7605;6433;8458;1108;2793;1088;2012;2125;HOSPITAL GENERAL DE AGUDOS DR. I. PIROVANO;
Cirugia;Cirugía General;1485;161;1646;1434;59;1493;164;1657;21907;14776;5986;4037;6745;892;2768;356;2012;2125;HOSPITAL GENERAL DE AGUDOS DR. I. PIROVANO;
Cirugia;Ginecología;884;81;965;778;8;786;179;965;7253;4550;1982;1243;6273;472;487;83;2012;2125;HOSPITAL GENERAL DE AGUDOS DR. I. PIROVANO;
Cirugia;Neurocirugía;269;106;375;268;9;277;100;377;6727;4191;1838;1145;623;1112;2051;239;2012;2125;HOSPITAL GENERAL DE AGUDOS DR. I. PIROVANO;
Cirugia;Oftalmología;109;5;114;91;1;92;20;112;2479;665;677;182;2683;594;1654;89;2012;2125;HOSPITAL GENERAL DE AGUDOS DR. I. PIROVANO;
Cirugia;Ortopedia Y Traumatología;644;119;763;621;16;637;131;768;18496;11135;5054;3042;602;145;152;208;2012;2125;HOSPITAL GENERAL DE AGUDOS DR. I. PIROVANO;
Cirugia;Otorrinolaringología;178;13;191;153;2;155;36;191;3214;1085;878;296;3376;568;2175;105;2012;2125;HOSPITAL GENERAL DE AGUDOS DR. I. PIROVANO;
Cirugia;Urología;328;81;409;370;5;375;35;410;4352;2558;1189;699;5878;624;3448;122;2012;2125;HOSPITAL GENERAL DE AGUDOS DR. I. PIROVANO;
Cirugia;Subtotal Cirugia;3897;566;4463;3715;100;3815;665;4480;64428;38960;17603;10645;6047;87;2545;223;2012;2125;HOSPITAL GENERAL DE AGUDOS DR. I. PIROVANO;
Pediatria;Recien Nacido Sano;1105;0;1105;953;0;953;150;1103;11689;3615;3194;988;3093;328;3454;0;2012;2125;HOSPITAL GENERAL DE AGUDOS DR. I. PIROVANO;
Pediatria;Neonatología;162;155;317;301;12;313;2;315;3415;2608;933;713;7637;828;3376;381;2012;2125;HOSPITAL GENERAL DE AGUDOS DR. I. PIROVANO;
Pediatria;Pediatría;1048;2;1050;1045;0;1045;5;1050;10710;3902;2926;1066;3643;372;3588;0;2012;2125;HOSPITAL GENERAL DE AGUDOS DR. I. PIROVANO;
Pediatria;Subtotal Pediatria;2315;157;2472;2299;12;2311;157;2468;25814;10125;7053;2766;3922;41;3499;49;2012;2125;HOSPITAL GENERAL DE AGUDOS DR. I. PIROVANO;
Tocoginecologia;Obstetricia;1827;7;1834;1800;0;1800;34;1834;11689;6750;3194;1844;5775;368;5743;0;2012;2125;HOSPITAL GENERAL DE AGUDOS DR. I. PIROVANO;
Tocoginecologia;Subtotal Tocoginecologia;1827;7;1834;1800;0;1800;34;1834;11689;6750;3194;1844;5775;368;5743;0;2012;2125;HOSPITAL GENERAL DE AGUDOS DR. I. PIROVANO;
Urgencia;Terapia Intermedia;25;158;183;21;17;38;144;182;1415;1174;387;321;8297;645;4708;934;2012;2125;HOSPITAL GENERAL DE AGUDOS DR. I. PIROVANO;
Urgencia;Terapia Intensiva;142;231;373;5;81;86;287;373;2928;2801;8;765;9566;751;4663;2172;2012;2125;HOSPITAL GENERAL DE AGUDOS DR. I. PIROVANO;
Urgencia;Subtotal Urgencia;167;389;556;26;98;124;431;555;4343;3975;1187;1086;9153;716;4677;1766;2012;2125;HOSPITAL GENERAL DE AGUDOS DR. I. PIROVANO;
Urgencia;Total Hospital;9779;1670;11449;9350;441;9791;1670;11461;134108;83353;36642;22774;6215;851;2672;45;2012;2125;HOSPITAL GENERAL DE AGUDOS DR. I. PIROVANO;
Medicina;Cardiología;209;311;520;415;4;419;98;517;6200;3238;1694;885;5223;626;3052;77;2012;2162;HOSPITAL GENERAL DE AGUDOS J. M. RAMOS MEJIA;
Medicina;Clínica Médica;635;994;1629;1272;124;1396;230;1626;34547;29945;9439;8182;8668;1842;1723;763;2012;2162;HOSPITAL GENERAL DE AGUDOS J. M. RAMOS MEJIA;
Medicina;Dermatología;100;26;126;108;3;111;12;123;3562;2673;973;73;7504;2173;1264;244;2012;2162;HOSPITAL GENERAL DE AGUDOS J. M. RAMOS MEJIA;
Medicina;Stroke ;1;0;1;1;0;1;1;2;1036;296;283;81;2857;148;71;0;2012;2162;HOSPITAL GENERAL DE AGUDOS J. M. RAMOS MEJIA;
Medicina;Hematología;212;25;237;215;13;228;13;241;4563;3114;1247;851;6824;1292;1933;539;2012;2162;HOSPITAL GENERAL DE AGUDOS J. M. RAMOS MEJIA;
Medicina;Neurología;339;139;478;429;7;436;50;486;5410;4624;1478;1263;8547;951;3288;144;2012;2162;HOSPITAL GENERAL DE AGUDOS J. M. RAMOS MEJIA;
Medicina;Tisiología;95;76;171;139;9;148;21;169;4940;2947;135;805;5966;1744;1252;533;2012;2162;HOSPITAL GENERAL DE AGUDOS J. M. RAMOS MEJIA;
Medicina;Unidad Coronaria;333;148;481;150;31;181;304;485;2593;2054;708;561;7921;424;6846;639;2012;2162;HOSPITAL GENERAL DE AGUDOS J. M. RAMOS MEJIA;
Medicina;Subtotal Medicina;1924;1719;3643;2729;191;2920;729;3649;62851;48891;17172;13358;7779;134;2125;523;2012;2162;HOSPITAL GENERAL DE AGUDOS J. M. RAMOS MEJIA;
Cirugia;Cirugía General;938;897;1835;1640;11;1651;180;1831;19927;14823;5445;405;7439;81;3363;6;2012;2162;HOSPITAL GENERAL DE AGUDOS J. M. RAMOS MEJIA;
Cirugia;Cirugía Plástica Y Reparadora - niÃ±os;420;45;465;421;0;421;43;464;4388;1496;1199;409;3409;322;387;0;2012;2162;HOSPITAL GENERAL DE AGUDOS J. M. RAMOS MEJIA;
Cirugia;Ginecología;421;43;464;433;5;438;26;464;6042;4311;1651;1178;7135;929;2811;108;2012;2162;HOSPITAL GENERAL DE AGUDOS J. M. RAMOS MEJIA;
Cirugia;Oftalmología;140;4;144;143;0;143;1;144;766;175;209;48;2285;122;688;0;2012;2162;HOSPITAL GENERAL DE AGUDOS J. M. RAMOS MEJIA;
Cirugia;Ortopedia Y Traumatología;321;92;413;361;7;368;31;399;10203;7719;2788;2109;7565;1935;1431;175;2012;2162;HOSPITAL GENERAL DE AGUDOS J. M. RAMOS MEJIA;
Cirugia;Otorrinolaringología;264;37;301;278;2;280;21;301;2397;1300;655;355;5423;432;4596;66;2012;2162;HOSPITAL GENERAL DE AGUDOS J. M. RAMOS MEJIA;
Cirugia;Urología;281;64;345;299;3;302;34;336;7320;4976;20;136;6798;1481;168;89;2012;2162;HOSPITAL GENERAL DE AGUDOS J. M. RAMOS MEJIA;
Cirugia;Subtotal Cirugia;2785;1182;3967;3575;28;3603;336;3939;51043;34800;13946;9508;6818;883;2824;71;2012;2162;HOSPITAL GENERAL DE AGUDOS J. M. RAMOS MEJIA;
Pediatria;Recien Nacido Sano;2782;0;2782;1422;0;1422;50;1472;5781;4236;158;1157;7327;288;9319;0;2012;2162;HOSPITAL GENERAL DE AGUDOS J. M. RAMOS MEJIA;
Pediatria;Neonatología;222;51;273;254;9;263;3;266;4625;3500;1264;956;7568;1316;2105;338;2012;2162;HOSPITAL GENERAL DE AGUDOS J. M. RAMOS MEJIA;
Pediatria;Pediatría;578;13;591;587;0;587;3;590;5584;3123;1526;853;5593;529;3867;0;2012;2162;HOSPITAL GENERAL DE AGUDOS J. M. RAMOS MEJIA;
Pediatria;Subtotal Pediatria;3582;64;3646;2263;9;2272;56;2328;15990;10859;4369;2967;6791;466;5329;39;2012;2162;HOSPITAL GENERAL DE AGUDOS J. M. RAMOS MEJIA;
Tocoginecologia;Obstetricia;2210;12;2222;2204;0;2204;14;2218;9528;7902;2603;2159;8293;356;852;0;2012;2162;HOSPITAL GENERAL DE AGUDOS J. M. RAMOS MEJIA;
Tocoginecologia;Subtotal Tocoginecologia;2210;12;2222;2204;0;2204;14;2218;9528;7902;2603;2159;8293;356;852;0;2012;2162;HOSPITAL GENERAL DE AGUDOS J. M. RAMOS MEJIA;
Urgencia;Guardia Del Día;2906;120;3026;773;225;998;2031;3029;5461;5437;1492;1486;9956;179;20301;743;2012;2162;HOSPITAL GENERAL DE AGUDOS J. M. RAMOS MEJIA;
Urgencia;Terapia Intensiva;16;308;324;5;81;86;239;325;3774;3286;1031;898;8707;1011;3152;2492;2012;2162;HOSPITAL GENERAL DE AGUDOS J. M. RAMOS MEJIA;
Urgencia;Subtotal Urgencia;2922;428;3350;778;306;1084;2270;3354;9235;8723;2523;2383;9446;26;13293;912;2012;2162;HOSPITAL GENERAL DE AGUDOS J. M. RAMOS MEJIA;
Urgencia;Total Hospital;13423;3405;16828;11549;534;12083;3405;15488;148647;111175;40614;30376;7479;92;2975;442;2012;2162;HOSPITAL GENERAL DE AGUDOS J. M. RAMOS MEJIA;
Medicina;Cardiología;38;151;189;164;0;164;26;190;2928;907;8;248;3098;477;2375;0;2012;2119;HOSPITAL GENERAL DE AGUDOS B. RIVADAVIA;
Medicina;Clínica Médica;651;122;773;611;54;665;100;765;17243;12065;4711;3296;6997;1577;1624;706;2012;2119;HOSPITAL GENERAL DE AGUDOS B. RIVADAVIA;
Medicina;Endocrinología;1;0;1;1;0;1;0;1;10;10;3;3;100;10;366;0;2012;2119;HOSPITAL GENERAL DE AGUDOS B. RIVADAVIA;
Medicina;Nutrición;62;8;70;69;0;69;3;72;4127;1328;1128;363;3218;1844;639;0;2012;2119;HOSPITAL GENERAL DE AGUDOS B. RIVADAVIA;
Medicina;Curieterapia;99;1;100;98;0;98;2;100;319;308;87;84;9655;308;11473;0;2012;2119;HOSPITAL GENERAL DE AGUDOS B. RIVADAVIA;
Medicina;Unidad Coronaria;170;54;224;42;11;53;170;223;2072;1246;566;34;6014;559;3939;493;2012;2119;HOSPITAL GENERAL DE AGUDOS B. RIVADAVIA;
Medicina;Subtotal Medicina;1021;336;1357;985;65;1050;301;1351;26699;15864;7295;4334;5942;1174;1852;481;2012;2119;HOSPITAL GENERAL DE AGUDOS B. RIVADAVIA;
Cirugia;Cirugía General;780;56;836;767;5;772;61;833;11576;3822;3163;1044;3302;459;2634;6;2012;2119;HOSPITAL GENERAL DE AGUDOS B. RIVADAVIA;
Cirugia;Cirugía Cardiovascular;36;17;53;37;0;37;16;53;1815;175;496;48;964;33;1069;0;2012;2119;HOSPITAL GENERAL DE AGUDOS B. RIVADAVIA;
Cirugia;Ginecología;410;8;418;409;1;410;10;420;3568;1466;975;401;4109;349;4308;24;2012;2119;HOSPITAL GENERAL DE AGUDOS B. RIVADAVIA;
Cirugia;Neurocirugía;89;30;119;92;1;93;26;119;1826;639;499;175;3499;537;2385;84;2012;2119;HOSPITAL GENERAL DE AGUDOS B. RIVADAVIA;
Cirugia;Ortopedia Y Traumatología;216;7;223;211;2;213;14;227;4413;2171;1206;593;492;956;1883;88;2012;2119;HOSPITAL GENERAL DE AGUDOS B. RIVADAVIA;
Cirugia;Otorrinolaringología;94;4;98;97;0;97;1;98;233;197;64;54;8455;201;15394;0;2012;2119;HOSPITAL GENERAL DE AGUDOS B. RIVADAVIA;
Cirugia;Urología;217;17;234;212;3;215;19;234;4393;1041;12;284;237;445;195;128;2012;2119;HOSPITAL GENERAL DE AGUDOS B. RIVADAVIA;
Cirugia;Subtotal Cirugia;1842;139;1981;1825;12;1837;147;1984;27824;9511;7602;2599;3418;479;261;6;2012;2119;HOSPITAL GENERAL DE AGUDOS B. RIVADAVIA;
Pediatria;Recien Nacido Sano;786;178;964;909;0;909;54;963;3390;3390;926;926;100;352;10397;0;2012;2119;HOSPITAL GENERAL DE AGUDOS B. RIVADAVIA;
Pediatria;Neonatología;284;55;339;137;15;152;190;342;6885;3728;1881;1019;5415;109;1818;439;2012;2119;HOSPITAL GENERAL DE AGUDOS B. RIVADAVIA;
Pediatria;Pediatría;667;13;680;676;1;677;2;679;5901;2630;1612;719;4457;387;4211;15;2012;2119;HOSPITAL GENERAL DE AGUDOS B. RIVADAVIA;
Pediatria;Subtotal Pediatria;1737;246;1983;1722;16;1738;246;1984;16176;9748;442;2663;6026;491;4489;81;2012;2119;HOSPITAL GENERAL DE AGUDOS B. RIVADAVIA;
Tocoginecologia;Obstetricia;1433;10;1443;1432;0;1432;9;1441;9586;7809;2619;2134;8146;542;5502;0;2012;2119;HOSPITAL GENERAL DE AGUDOS B. RIVADAVIA;
Tocoginecologia;Subtotal Tocoginecologia;1433;10;1443;1432;0;1432;9;1441;9586;7809;2619;2134;8146;542;5502;0;2012;2119;HOSPITAL GENERAL DE AGUDOS B. RIVADAVIA;
Urgencia;Coordinacion Cuidados Intensivos;100;154;254;10;61;71;182;253;2933;2162;801;591;7371;855;3157;2411;2012;2119;HOSPITAL GENERAL DE AGUDOS B. RIVADAVIA;
Urgencia;Subtotal Urgencia;100;154;254;10;61;71;182;253;2933;2162;801;591;7371;855;3157;2411;2012;2119;HOSPITAL GENERAL DE AGUDOS B. RIVADAVIA;
Urgencia;Total Hospital;6133;885;7018;5974;154;6128;885;7013;83218;45094;22737;12321;5419;736;2695;251;2012;2119;HOSPITAL GENERAL DE AGUDOS B. RIVADAVIA;
Medicina;Cardiología;147;241;388;306;2;308;76;384;3052;1908;834;521;6252;497;4605;52;2012;2121;HOSPITAL GENERAL DE AGUDOS DONACION F. SANTOJANNI;
Medicina;Clínica Médica;1019;327;1346;972;224;1196;149;1345;21208;20332;5795;5555;9587;1512;2321;1665;2012;2121;HOSPITAL GENERAL DE AGUDOS DONACION F. SANTOJANNI;
Medicina;Unidad Coronaria;468;153;621;243;58;301;323;624;2923;1959;799;535;6702;314;7813;929;2012;2121;HOSPITAL GENERAL DE AGUDOS DONACION F. SANTOJANNI;
Medicina;Subtotal Medicina;1634;721;2355;1521;284;1805;548;2353;27183;24199;7427;6612;8902;1028;3168;1207;2012;2121;HOSPITAL GENERAL DE AGUDOS DONACION F. SANTOJANNI;
Cirugia;Cirugía General;1175;162;1337;1264;9;1273;73;1346;8639;8073;236;2206;9345;6;5702;67;2012;2121;HOSPITAL GENERAL DE AGUDOS DONACION F. SANTOJANNI;
Cirugia;Cirugía Cardiovascular;12;2;14;14;0;14;0;14;37;34;1;9;9189;243;13849;0;2012;2121;HOSPITAL GENERAL DE AGUDOS DONACION F. SANTOJANNI;
Cirugia;Microcirugia Y Cirugia Reparadora;343;3;346;342;1;343;3;346;980;970;268;265;9898;28;12922;29;2012;2121;HOSPITAL GENERAL DE AGUDOS DONACION F. SANTOJANNI;
Cirugia;Ginecología;629;31;660;647;3;650;11;661;2978;2610;814;713;8764;395;8124;45;2012;2121;HOSPITAL GENERAL DE AGUDOS DONACION F. SANTOJANNI;
Cirugia;Neurocirugía;151;32;183;152;6;158;30;188;3894;3376;1064;922;867;1796;1767;319;2012;2121;HOSPITAL GENERAL DE AGUDOS DONACION F. SANTOJANNI;
Cirugia;Oftalmología;3;0;3;3;0;3;0;3;3;0;1;1;100;1;366;0;2012;2121;HOSPITAL GENERAL DE AGUDOS DONACION F. SANTOJANNI;
Cirugia;Ortopedia Y Traumatología;548;42;590;554;16;570;17;587;7651;7595;209;2075;9927;1294;2808;273;2012;2121;HOSPITAL GENERAL DE AGUDOS DONACION F. SANTOJANNI;
Cirugia;Otorrinolaringología;30;2;32;30;0;30;2;32;120;120;33;33;100;375;976;0;2012;2121;HOSPITAL GENERAL DE AGUDOS DONACION F. SANTOJANNI;
Cirugia;Urología;341;17;358;351;2;353;6;359;1767;1740;483;475;9847;485;7436;56;2012;2121;HOSPITAL GENERAL DE AGUDOS DONACION F. SANTOJANNI;
Cirugia;Subtotal Cirugia;3232;291;3523;3357;37;3394;142;3536;26069;24521;7123;67;9406;693;4964;105;2012;2121;HOSPITAL GENERAL DE AGUDOS DONACION F. SANTOJANNI;
Pediatria;Recien Nacido Sano;3648;232;3880;3849;0;3849;37;3886;21960;15282;60;4175;6959;393;6477;0;2012;2121;HOSPITAL GENERAL DE AGUDOS DONACION F. SANTOJANNI;
Pediatria;Neonatología;465;183;648;248;33;281;361;642;10670;6207;2915;1696;5817;967;2202;514;2012;2121;HOSPITAL GENERAL DE AGUDOS DONACION F. SANTOJANNI;
Tocoginecologia;Obstetricia;2087;14;2101;2055;0;2055;46;2101;9108;6291;2495;1724;6907;299;842;0;2013;2126;HOSPITAL GENERAL DE AGUDOS DR. T. ALVAREZ;
Tocoginecologia;Subtotal Tocoginecologia;2087;14;2101;2055;0;2055;46;2101;9108;6291;2495;1724;6907;299;842;0;2013;2126;HOSPITAL GENERAL DE AGUDOS DR. T. ALVAREZ;
Urgencia;Guardia Del Día;2073;14;2087;447;75;522;1564;2086;2473;1291;678;354;522;62;30788;36;2013;2126;HOSPITAL GENERAL DE AGUDOS DR. T. ALVAREZ;
Urgencia;Terapia Intensiva;18;241;259;25;83;108;151;259;2936;2256;804;618;7684;871;322;3205;2013;2126;HOSPITAL GENERAL DE AGUDOS DR. T. ALVAREZ;
Urgencia;Subtotal Urgencia;2091;255;2346;472;158;630;1715;2345;5409;3547;1482;972;6558;151;15824;674;2013;2126;HOSPITAL GENERAL DE AGUDOS DR. T. ALVAREZ;
Urgencia;Total Hospital;8397;2765;11162;8054;328;8382;2765;11147;79944;55948;21902;15328;6998;667;3827;391;2013;2126;HOSPITAL GENERAL DE AGUDOS DR. T. ALVAREZ;
Medicina;Cardiología Intervencionista;259;0;259;259;0;259;0;259;482;232;132;64;4813;9;19613;0;2013;2122;HOSPITAL GENERAL DE AGUDOS DR C. ARGERICH;
Medicina;Cardiología;239;352;591;499;11;510;74;584;8426;5821;2308;1595;6908;997;253;188;2013;2122;HOSPITAL GENERAL DE AGUDOS DR C. ARGERICH;
Medicina;Clínica Médica;380;373;753;548;46;594;160;754;12410;10610;34;2907;855;1407;2218;61;2013;2122;HOSPITAL GENERAL DE AGUDOS DR C. ARGERICH;
Medicina;Unidad Coronaria;323;131;454;53;52;105;347;452;2920;2373;8;65;8127;525;565;115;2013;2122;HOSPITAL GENERAL DE AGUDOS DR C. ARGERICH;
Medicina;Subtotal Medicina;1201;856;2057;1359;109;1468;581;2049;24238;19036;6641;5215;7854;929;3086;532;2013;2122;HOSPITAL GENERAL DE AGUDOS DR C. ARGERICH;
Cirugia;Cirugía General;2796;164;2960;2802;28;2830;127;2957;20075;17460;55;4784;8697;59;5376;95;2013;2122;HOSPITAL GENERAL DE AGUDOS DR C. ARGERICH;
Cirugia;Cirugía Cardiovascular;206;70;276;193;6;199;75;274;5840;3743;16;1025;6409;1366;1713;219;2013;2122;HOSPITAL GENERAL DE AGUDOS DR C. ARGERICH;
Cirugia;Ginecología;332;20;352;339;3;342;10;352;4745;4481;13;1228;9444;1273;2708;85;2013;2122;HOSPITAL GENERAL DE AGUDOS DR C. ARGERICH;
Cirugia;Neurocirugía;200;108;308;243;7;250;59;309;8517;6725;2333;1842;7896;2176;1324;227;2013;2122;HOSPITAL GENERAL DE AGUDOS DR C. ARGERICH;
Cirugia;Ortopedia Y Traumatología;447;34;481;467;9;476;15;491;8030;5865;22;1607;7304;1195;2232;183;2013;2122;HOSPITAL GENERAL DE AGUDOS DR C. ARGERICH;
Cirugia;Urología;288;24;312;291;1;292;21;313;4133;3071;1132;841;743;981;2764;32;2013;2122;HOSPITAL GENERAL DE AGUDOS DR C. ARGERICH;
Cirugia;Trasplante Renal;419;55;474;423;9;432;42;474;7671;4879;2102;1337;636;1029;2255;19;2013;2122;HOSPITAL GENERAL DE AGUDOS DR C. ARGERICH;
Cirugia;Subtotal Cirugia;4688;475;5163;4758;63;4821;349;5170;59011;46224;16167;12664;7833;894;3198;122;2013;2122;HOSPITAL GENERAL DE AGUDOS DR C. ARGERICH;
Pediatria;Recien Nacido Sano;2400;206;2606;2010;0;2010;597;2607;13505;5716;37;1566;4233;219;7046;0;2013;2122;HOSPITAL GENERAL DE AGUDOS DR C. ARGERICH;
Pediatria;Neonatología;110;598;708;478;28;506;212;718;9855;6425;27;176;652;895;2659;39;2013;2122;HOSPITAL GENERAL DE AGUDOS DR C. ARGERICH;
Pediatria;Pediatría;499;16;515;513;0;513;3;516;6570;3223;18;883;4906;625;2867;0;2013;2122;HOSPITAL GENERAL DE AGUDOS DR C. ARGERICH;
Pediatria;Subtotal Pediatria;3009;820;3829;3001;28;3029;812;3841;29930;15364;82;4209;5133;4;4684;73;2013;2122;HOSPITAL GENERAL DE AGUDOS DR C. ARGERICH;
Tocoginecologia;Obstetricia;2962;17;2979;2961;1;2962;21;2983;13517;10495;3703;2875;7764;352;8055;3;2013;2122;HOSPITAL GENERAL DE AGUDOS DR C. ARGERICH;
Tocoginecologia;Subtotal Tocoginecologia;2962;17;2979;2961;1;2962;21;2983;13517;10495;3703;2875;7764;352;8055;3;2013;2122;HOSPITAL GENERAL DE AGUDOS DR C. ARGERICH;
Urgencia;Guardia Del Día;1277;12;1289;748;147;895;391;1286;7299;7299;20;20;100;568;6431;1143;2013;2122;HOSPITAL GENERAL DE AGUDOS DR C. ARGERICH;
Urgencia;Terapia Intensiva;202;374;576;36;139;175;400;575;5718;4888;1567;1339;8548;85;367;2417;2013;2122;HOSPITAL GENERAL DE AGUDOS DR C. ARGERICH;
Urgencia;Subtotal Urgencia;1479;386;1865;784;286;1070;791;1861;13017;12187;3566;3339;9362;655;5218;1537;2013;2122;HOSPITAL GENERAL DE AGUDOS DR C. ARGERICH;
Urgencia;Total Hospital;13339;2554;15893;12863;487;13350;2554;15904;139713;103306;38278;28303;7394;774;3488;365;2013;2122;HOSPITAL GENERAL DE AGUDOS DR C. ARGERICH;
Medicina;Cardiología;65;258;323;206;4;210;105;315;8285;3050;227;836;3681;968;1388;127;2013;2123;HOSPITAL GENERAL DE AGUDOS DR. C. DURAND;
Medicina;Clínica Médica;723;382;1105;894;90;984;122;1106;19128;14949;5241;4096;7815;1352;211;814;2013;2123;HOSPITAL GENERAL DE AGUDOS DR. C. DURAND;
Medicina;Geriatría;176;91;267;187;67;254;9;263;8140;7018;223;1923;8622;2668;1179;2548;2013;2123;HOSPITAL GENERAL DE AGUDOS DR. C. DURAND;
Medicina;Unidad Coronaria;293;100;393;108;28;136;261;397;3645;1914;999;524;5251;482;3975;705;2013;2123;HOSPITAL GENERAL DE AGUDOS DR. C. DURAND;
Medicina;Subtotal Medicina;1257;831;2088;1395;189;1584;497;2081;39198;26931;10739;7378;6871;1294;1938;908;2013;2123;HOSPITAL GENERAL DE AGUDOS DR. C. DURAND;
Cirugia;Cirugía General;685;122;807;683;4;687;115;802;3617;3622;991;992;10014;452;8093;5;2013;2123;HOSPITAL GENERAL DE AGUDOS DR. C. DURAND;
Cirugia;Cirugía Cardiovascular;61;64;125;48;7;55;70;125;1454;823;398;225;566;658;3138;56;2013;2123;HOSPITAL GENERAL DE AGUDOS DR. C. DURAND;
Cirugia;Cirugía Plástica Y Reparadora - niÃ±os;45;2;47;44;0;44;2;46;92;95;25;26;10326;207;1825;0;2013;2123;HOSPITAL GENERAL DE AGUDOS DR. C. DURAND;
Urgencia;Terapia Intermedia;62;314;376;35;20;55;320;375;4392;3892;1203;1066;8862;1038;3116;533;2013;2127;HOSPITAL GENERAL DE AGUDOS DR. J. A. FERNANDEZ;
Urgencia;Toxicología;230;12;242;229;1;230;9;239;2928;1533;802;42;5236;641;2979;42;2013;2127;HOSPITAL GENERAL DE AGUDOS DR. J. A. FERNANDEZ;
Urgencia;Terapia Intensiva;209;273;482;5;102;107;370;477;6556;5348;1796;1465;8157;1121;2656;2138;2013;2127;HOSPITAL GENERAL DE AGUDOS DR. J. A. FERNANDEZ;
Urgencia;Subtotal Urgencia;501;599;1100;269;123;392;699;1091;13876;10773;3802;2952;7764;987;287;1127;2013;2127;HOSPITAL GENERAL DE AGUDOS DR. J. A. FERNANDEZ;
Urgencia;Total Hospital;9659;2325;11984;9221;398;9619;2325;11944;132678;102096;3635;27972;7695;1061;2646;414;2013;2127;HOSPITAL GENERAL DE AGUDOS DR. J. A. FERNANDEZ;
Medicina;Clínica Médica;13;544;557;415;80;495;56;551;17576;16511;4815;4524;9394;2997;1144;1452;2013;2161;HOSPITAL GENERAL DE AGUDOS J. A. PENNA;
Medicina;Subtotal Medicina;13;544;557;415;80;495;56;551;17576;16511;4815;4524;9394;2997;1144;1452;2013;2161;HOSPITAL GENERAL DE AGUDOS J. A. PENNA;
Cirugia;Cirugía General;903;482;1385;1308;9;1317;75;1392;12527;7436;3432;2037;5936;534;4056;65;2013;2161;HOSPITAL GENERAL DE AGUDOS J. A. PENNA;
Cirugia;Ortopedia Y Traumatología;38;304;342;324;2;326;15;341;6370;5705;1745;1563;8956;1673;1954;59;2013;2161;HOSPITAL GENERAL DE AGUDOS J. A. PENNA;
Cirugia;Urología;235;77;312;302;2;304;7;311;2289;1883;627;516;8226;605;4959;64;2013;2161;HOSPITAL GENERAL DE AGUDOS J. A. PENNA;
Cirugia;Subtotal Cirugia;1176;863;2039;1934;13;1947;97;2044;21186;15024;5804;4116;7091;735;3521;64;2013;2161;HOSPITAL GENERAL DE AGUDOS J. A. PENNA;
Pediatria;Recien Nacido Sano;3009;509;3518;3275;0;3275;245;3520;17672;13329;4842;3652;7542;379;727;0;2013;2161;HOSPITAL GENERAL DE AGUDOS J. A. PENNA;
Pediatria;Neonatología;713;216;929;398;36;434;483;917;8529;6804;2337;1864;7977;742;3924;393;2013;2161;HOSPITAL GENERAL DE AGUDOS J. A. PENNA;
Pediatria;Pediatría;895;8;903;901;1;902;0;902;7066;4245;1936;1163;6008;471;4659;11;2013;2161;HOSPITAL GENERAL DE AGUDOS J. A. PENNA;
Pediatria;Subtotal Pediatria;4617;733;5350;4574;37;4611;728;5339;33267;24378;9114;6679;7328;457;5858;69;2013;2161;HOSPITAL GENERAL DE AGUDOS J. A. PENNA;
Tocoginecologia;Tocoginecología;5736;258;5994;5727;4;5731;255;5986;25472;23325;6979;639;9157;39;8578;7;2013;2161;HOSPITAL GENERAL DE AGUDOS J. A. PENNA;
Tocoginecologia;Subtotal Tocoginecologia;5736;258;5994;5727;4;5731;255;5986;25472;23325;6979;639;9157;39;8578;7;2013;2161;HOSPITAL GENERAL DE AGUDOS J. A. PENNA;
Urgencia;Terapia Intermedia;0;167;167;19;9;28;138;166;932;782;255;214;8391;471;6501;542;2013;2161;HOSPITAL GENERAL DE AGUDOS J. A. PENNA;
Urgencia;Guardia Del Día;2910;1;2911;1370;174;1544;1363;2907;8488;8488;2325;2325;100;292;12501;599;2013;2161;HOSPITAL GENERAL DE AGUDOS J. A. PENNA;
Urgencia;Terapia Intensiva;5;258;263;10;68;78;186;264;2548;2392;698;655;9388;906;3782;2576;2013;2161;HOSPITAL GENERAL DE AGUDOS J. A. PENNA;
Urgencia;Subtotal Urgencia;2915;426;3341;1399;251;1650;1687;3337;11968;11662;3279;3195;9744;349;10177;752;2013;2161;HOSPITAL GENERAL DE AGUDOS J. A. PENNA;
Urgencia;Total Hospital;14457;2824;17281;14049;385;14434;2823;17257;109469;90900;29992;24904;8304;63;4813;267;2013;2161;HOSPITAL GENERAL DE AGUDOS J. A. PENNA;
Medicina;Psicopatologia Y Salud Mental;278;75;353;349;0;349;6;355;7300;4790;20;1312;6562;1349;1775;0;2013;2163;HOSPITAL GENERAL DE AGUDOS P. PIÑERO;
Medicina;Subtotal Medicina;278;75;353;349;0;349;6;355;7300;4790;20;1312;6562;1349;1775;0;2013;2163;HOSPITAL GENERAL DE AGUDOS P. PIÑERO;
Cirugia;Ginecología;450;29;479;446;4;450;26;476;3825;1968;1048;539;5145;413;4542;84;2013;2163;HOSPITAL GENERAL DE AGUDOS P. PIÑERO;
Cirugia;Subtotal Cirugia;450;29;479;446;4;450;26;476;3825;1968;1048;539;5145;413;4542;84;2013;2163;HOSPITAL GENERAL DE AGUDOS P. PIÑERO;
Pediatria;Recien Nacido Sano;2702;3;2705;2369;0;2369;335;2704;9473;7916;2595;2169;8356;293;10419;0;2013;2163;HOSPITAL GENERAL DE AGUDOS P. PIÑERO;
Pediatria;Neonatología;79;335;414;387;20;407;6;413;6570;3941;18;108;5998;954;2294;484;2013;2163;HOSPITAL GENERAL DE AGUDOS P. PIÑERO;
Pediatria;Pediatría;1359;8;1367;1364;2;1366;2;1368;8760;4548;24;1246;5192;332;57;15;2013;2163;HOSPITAL GENERAL DE AGUDOS P. PIÑERO;
Pediatria;Subtotal Pediatria;4140;346;4486;4120;22;4142;343;4485;24803;16405;6795;4495;6614;366;66;49;2013;2163;HOSPITAL GENERAL DE AGUDOS P. PIÑERO;
Tocoginecologia;Obstetricia;3508;116;3624;3502;0;3502;124;3626;17727;12233;4857;3352;6901;337;7466;0;2013;2163;HOSPITAL GENERAL DE AGUDOS P. PIÑERO;
Tocoginecologia;Subtotal Tocoginecologia;3508;116;3624;3502;0;3502;124;3626;17727;12233;4857;3352;6901;337;7466;0;2013;2163;HOSPITAL GENERAL DE AGUDOS P. PIÑERO;
Urgencia;Guardia Del Día;3526;58;3584;1221;207;1428;2150;3578;4570;4544;1252;1245;9943;127;28577;579;2013;2163;HOSPITAL GENERAL DE AGUDOS P. PIÑERO;
Urgencia;Terapia Intensiva;4;235;239;10;81;91;147;238;2920;2243;8;615;7682;942;2975;3403;2013;2163;HOSPITAL GENERAL DE AGUDOS P. PIÑERO;
Urgencia;Subtotal Urgencia;3530;293;3823;1231;288;1519;2297;3816;7490;6787;2052;1859;9061;178;18596;755;2013;2163;HOSPITAL GENERAL DE AGUDOS P. PIÑERO;
Area Indiferenciada;Area Indiferenciada;922;2238;3160;2663;189;2852;301;3153;52925;37880;145;10378;7157;1201;2174;599;2013;2163;HOSPITAL GENERAL DE AGUDOS P. PIÑERO;
Area Indiferenciada;Subtotal Area Indiferenciada;922;2238;3160;2663;189;2852;301;3153;52925;37880;145;10378;7157;1201;2174;599;2013;2163;HOSPITAL GENERAL DE AGUDOS P. PIÑERO;
Area Indiferenciada;Total Hospital;12828;3097;15925;12311;503;12814;3097;15911;114070;80063;31252;21935;7019;625;41;393;2013;2163;HOSPITAL GENERAL DE AGUDOS P. PIÑERO;
Medicina;Cardiología;0;68;68;51;0;51;17;68;738;499;202;137;6762;734;3363;0;2013;2125;HOSPITAL GENERAL DE AGUDOS DR. I. PIROVANO;
Medicina;Clínica Médica;1143;347;1490;1092;209;1301;184;1485;22536;20617;6174;5648;9148;1388;2405;1407;2013;2125;HOSPITAL GENERAL DE AGUDOS DR. I. PIROVANO;
Medicina;Unidad Coronaria;234;42;276;175;17;192;84;276;2190;1956;6;536;8932;709;46;616;2013;2125;HOSPITAL GENERAL DE AGUDOS DR. I. PIROVANO;
Medicina;Subtotal Medicina;1377;457;1834;1318;226;1544;285;1829;25464;23072;6976;6321;9061;1261;2622;1236;2013;2125;HOSPITAL GENERAL DE AGUDOS DR. I. PIROVANO;
Cirugia;Cirugía General;1442;170;1612;1405;42;1447;169;1616;18795;13777;5149;3775;733;853;3138;26;2013;2125;HOSPITAL GENERAL DE AGUDOS DR. I. PIROVANO;
Cirugia;Ginecología;961;80;1041;838;7;845;191;1036;6570;5617;18;1539;8549;542;5756;68;2013;2125;HOSPITAL GENERAL DE AGUDOS DR. I. PIROVANO;
Cirugia;Neurocirugía;232;101;333;227;3;230;105;335;4744;3111;13;852;6558;929;2577;9;2013;2125;HOSPITAL GENERAL DE AGUDOS DR. I. PIROVANO;
Cirugia;Oftalmología;104;13;117;96;0;96;20;116;1871;666;513;182;356;574;2263;0;2013;2125;HOSPITAL GENERAL DE AGUDOS DR. I. PIROVANO;
Cirugia;Ortopedia Y Traumatología;606;102;708;557;31;588;110;698;15797;10958;4328;3002;6937;157;1613;444;2013;2125;HOSPITAL GENERAL DE AGUDOS DR. I. PIROVANO;
Cirugia;Otorrinolaringología;219;11;230;176;5;181;49;230;2598;1317;712;361;5069;573;3231;217;2013;2125;HOSPITAL GENERAL DE AGUDOS DR. I. PIROVANO;
Cirugia;Urología;361;86;447;408;5;413;32;445;4428;2846;1213;78;6427;64;3668;112;2013;2125;HOSPITAL GENERAL DE AGUDOS DR. I. PIROVANO;
Cirugia;Subtotal Cirugia;3925;563;4488;3707;93;3800;676;4476;54803;38292;15015;10491;6987;855;2981;208;2013;2125;HOSPITAL GENERAL DE AGUDOS DR. I. PIROVANO;
Pediatria;Recien Nacido Sano;1010;1;1011;914;0;914;96;1010;10792;2941;2957;806;2725;291;3416;0;2013;2125;HOSPITAL GENERAL DE AGUDOS DR. I. PIROVANO;
Pediatria;Neonatología;246;98;344;338;5;343;2;345;3708;3410;1016;934;9196;988;3396;145;2013;2125;HOSPITAL GENERAL DE AGUDOS DR. I. PIROVANO;
Pediatria;Pediatría;1075;1;1076;1069;1;1070;3;1073;9551;4000;2617;1096;4188;373;4101;9;2013;2125;HOSPITAL GENERAL DE AGUDOS DR. I. PIROVANO;
Pediatria;Subtotal Pediatria;2331;100;2431;2321;6;2327;101;2428;24051;10351;6589;2836;4304;426;3685;25;2013;2125;HOSPITAL GENERAL DE AGUDOS DR. I. PIROVANO;
Tocoginecologia;Obstetricia;1817;9;1826;1782;0;1782;40;1822;10793;6318;2957;1731;5854;347;6162;0;2013;2125;HOSPITAL GENERAL DE AGUDOS DR. I. PIROVANO;
Tocoginecologia;Subtotal Tocoginecologia;1817;9;1826;1782;0;1782;40;1822;10793;6318;2957;1731;5854;347;6162;0;2013;2125;HOSPITAL GENERAL DE AGUDOS DR. I. PIROVANO;
Urgencia;Terapia Intermedia;12;127;139;24;6;30;109;139;1460;1149;4;315;787;827;3475;432;2013;2125;HOSPITAL GENERAL DE AGUDOS DR. I. PIROVANO;
Urgencia;Terapia Intensiva;117;251;368;4;69;73;296;369;2921;2808;8;769;9613;761;4611;187;2013;2125;HOSPITAL GENERAL DE AGUDOS DR. I. PIROVANO;
Urgencia;Subtotal Urgencia;129;378;507;28;75;103;405;508;4381;3957;12;1084;9032;779;4232;1476;2013;2125;HOSPITAL GENERAL DE AGUDOS DR. I. PIROVANO;
Urgencia;Total Hospital;9579;1507;11086;9156;400;9556;1507;11063;119492;81990;32738;22463;6862;858;2919;419;2013;2125;HOSPITAL GENERAL DE AGUDOS DR. I. PIROVANO;
Medicina;Cardiología;213;297;510;405;2;407;106;513;6250;3247;1712;89;5195;633;2996;39;2013;2162;HOSPITAL GENERAL DE AGUDOS J. M. RAMOS MEJIA;
Medicina;Clínica Médica;642;1051;1693;1354;131;1485;211;1696;35754;31498;9796;863;881;1857;1731;772;2013;2162;HOSPITAL GENERAL DE AGUDOS J. M. RAMOS MEJIA;
Medicina;Dermatología;68;18;86;70;0;70;22;92;3377;2313;925;634;6849;2514;994;0;2013;2162;HOSPITAL GENERAL DE AGUDOS J. M. RAMOS MEJIA;
Medicina;Hematología;109;47;156;136;7;143;13;156;3331;2719;913;745;8163;1743;1709;449;2013;2162;HOSPITAL GENERAL DE AGUDOS J. M. RAMOS MEJIA;
Medicina;Neurología;337;129;466;427;4;431;38;469;5284;3817;1448;1046;7224;814;324;85;2013;2162;HOSPITAL GENERAL DE AGUDOS J. M. RAMOS MEJIA;
Medicina;Tisiología;83;65;148;122;6;128;20;148;3770;2096;1033;574;556;1416;1433;405;2013;2162;HOSPITAL GENERAL DE AGUDOS J. M. RAMOS MEJIA;
Cirugia;Oftalmología;4;;;;;;;;;;1;;;;;;2013;2123;HOSPITAL GENERAL DE AGUDOS DR. C. DURAND;
Cirugia;Ortopedia Y Traumatología;381;30;411;366;4;370;34;404;3474;3476;952;952;10006;86;4245;99;2013;2123;HOSPITAL GENERAL DE AGUDOS DR. C. DURAND;
Cirugia;Otorrinolaringología;97;5;102;100;0;100;2;102;448;448;123;123;100;439;831;0;2013;2123;HOSPITAL GENERAL DE AGUDOS DR. C. DURAND;
Cirugia;Urología;348;39;387;350;3;353;33;386;1192;1194;327;327;10017;309;1182;78;2013;2123;HOSPITAL GENERAL DE AGUDOS DR. C. DURAND;
Cirugia;Vascular Periférico;48;15;63;42;2;44;20;64;407;406;112;111;9975;634;574;313;2013;2123;HOSPITAL GENERAL DE AGUDOS DR. C. DURAND;
Cirugia;Subtotal Cirugia;1665;277;1942;1633;20;1653;276;1929;10688;10064;2928;2757;9416;522;6588;104;2013;2123;HOSPITAL GENERAL DE AGUDOS DR. C. DURAND;
Pediatria;Recien Nacido Sano;1464;172;1636;1598;0;1598;41;1639;9108;5613;2495;1538;6163;342;6568;0;2013;2123;HOSPITAL GENERAL DE AGUDOS DR. C. DURAND;
Pediatria;Neonatología;413;180;593;257;12;269;312;581;7301;4973;20;1362;6811;856;2905;207;2013;2123;HOSPITAL GENERAL DE AGUDOS DR. C. DURAND;
Pediatria;Pediatría;859;33;892;852;0;852;34;886;10214;4043;2798;1108;3958;456;3166;0;2013;2123;HOSPITAL GENERAL DE AGUDOS DR. C. DURAND;
Pediatria;Subtotal Pediatria;2736;385;3121;2707;12;2719;387;3106;26623;14629;7294;4008;5495;471;4258;39;2013;2123;HOSPITAL GENERAL DE AGUDOS DR. C. DURAND;
Tocoginecologia;Tocoginecología;2752;51;2803;2759;3;2762;52;2814;18081;12244;4954;3355;6772;435;5681;11;2013;2123;HOSPITAL GENERAL DE AGUDOS DR. C. DURAND;
Tocoginecologia;Subtotal Tocoginecologia;2752;51;2803;2759;3;2762;52;2814;18081;12244;4954;3355;6772;435;5681;11;2013;2123;HOSPITAL GENERAL DE AGUDOS DR. C. DURAND;
Urgencia;Terapia Intermedia;69;32;101;64;3;67;32;99;2915;1702;799;466;5839;1719;124;303;2013;2123;HOSPITAL GENERAL DE AGUDOS DR. C. DURAND;
Urgencia;Cuidados Intermedios;69;150;219;32;12;44;170;214;1672;1407;458;385;8415;657;4672;561;2013;2123;HOSPITAL GENERAL DE AGUDOS DR. C. DURAND;
Urgencia;Guardia Del Día;400;7;407;113;38;151;254;405;3177;2462;87;675;7749;608;4653;938;2013;2123;HOSPITAL GENERAL DE AGUDOS DR. C. DURAND;
Urgencia;Terapia Intensiva;147;249;396;9;79;88;314;402;4165;3140;1141;86;7539;781;3523;1965;2013;2123;HOSPITAL GENERAL DE AGUDOS DR. C. DURAND;
Urgencia;Subtotal Urgencia;685;438;1123;218;132;350;770;1120;11929;8711;3268;2387;7302;778;3427;1179;2013;2123;HOSPITAL GENERAL DE AGUDOS DR. C. DURAND;
Urgencia;Total Hospital;9095;1982;11077;8712;356;9068;1982;11050;106519;72579;29183;19885;6814;8;3107;393;2013;2123;HOSPITAL GENERAL DE AGUDOS DR. C. DURAND;
Medicina;Cardiología;124;194;318;203;5;208;112;320;2250;1733;616;475;7702;542;5191;156;2013;2127;HOSPITAL GENERAL DE AGUDOS DR. J. A. FERNANDEZ;
Medicina;Clínica Médica;1075;478;1553;1137;167;1304;242;1546;28876;26477;7911;7254;9169;1713;1954;108;2013;2127;HOSPITAL GENERAL DE AGUDOS DR. J. A. FERNANDEZ;
Medicina;Unidad Coronaria;364;94;458;226;40;266;191;457;3660;2097;1003;575;573;459;4558;875;2013;2127;HOSPITAL GENERAL DE AGUDOS DR. J. A. FERNANDEZ;
Medicina;Subtotal Medicina;1563;766;2329;1566;212;1778;545;2323;34786;30307;953;8303;8712;1305;2437;913;2013;2127;HOSPITAL GENERAL DE AGUDOS DR. J. A. FERNANDEZ;
Cirugia;Cirugía General;941;243;1184;913;20;933;242;1175;16104;13947;4412;3821;8661;1187;2663;17;2013;2127;HOSPITAL GENERAL DE AGUDOS DR. J. A. FERNANDEZ;
Cirugia;Ginecología;644;329;973;821;10;831;145;976;7300;5050;20;1384;6918;517;488;102;2013;2127;HOSPITAL GENERAL DE AGUDOS DR. J. A. FERNANDEZ;
Cirugia;Neurocirugía;126;112;238;160;2;162;72;234;4370;3988;1197;1093;9126;1704;1954;85;2013;2127;HOSPITAL GENERAL DE AGUDOS DR. J. A. FERNANDEZ;
Cirugia;Ortopedia Y Traumatología;895;99;994;855;6;861;135;996;17548;13209;4808;3619;7527;1326;2072;6;2013;2127;HOSPITAL GENERAL DE AGUDOS DR. J. A. FERNANDEZ;
Cirugia;Urología;208;24;232;191;0;191;38;229;3596;3305;985;905;9191;1443;2324;0;2013;2127;HOSPITAL GENERAL DE AGUDOS DR. J. A. FERNANDEZ;
Cirugia;Subtotal Cirugia;2814;807;3621;2940;38;2978;632;3610;48918;39499;13402;10822;8075;1094;2694;105;2013;2127;HOSPITAL GENERAL DE AGUDOS DR. J. A. FERNANDEZ;
Pediatria;Recien Nacido Sano;1479;39;1518;1424;0;1424;89;1513;9949;4449;2726;1219;4472;294;5551;0;2013;2127;HOSPITAL GENERAL DE AGUDOS DR. J. A. FERNANDEZ;
Pediatria;Neonatología;374;89;463;389;23;412;44;456;8073;6247;2212;1712;7738;137;2062;504;2013;2127;HOSPITAL GENERAL DE AGUDOS DR. J. A. FERNANDEZ;
Pediatria;Pediatría;724;7;731;736;1;737;0;737;6085;3482;1667;954;5722;472;4421;14;2013;2127;HOSPITAL GENERAL DE AGUDOS DR. J. A. FERNANDEZ;
Pediatria;Subtotal Pediatria;2577;135;2712;2549;24;2573;133;2706;24107;14178;6605;3884;5881;524;4097;89;2013;2127;HOSPITAL GENERAL DE AGUDOS DR. J. A. FERNANDEZ;
Tocoginecologia;Obstetricia;2204;18;2222;1897;1;1898;316;2214;10991;7339;3011;2011;6677;331;7352;5;2013;2127;HOSPITAL GENERAL DE AGUDOS DR. J. A. FERNANDEZ;
Tocoginecologia;Subtotal Tocoginecologia;2204;18;2222;1897;1;1898;316;2214;10991;7339;3011;2011;6677;331;7352;5;2013;2127;HOSPITAL GENERAL DE AGUDOS DR. J. A. FERNANDEZ;
Cuidados Especiales;Cuidados Intermedios;71;159;230;65;3;68;159;227;2941;2448;804;669;8324;1078;2825;132;2012;2172;HOSPITAL GENERAL DE NIÑOS PEDRO DE ELIZALDE;
Cuidados Especiales;Cuidados Intensivos;133;227;360;9;36;45;313;358;4026;2355;11;643;5849;658;3255;1006;2012;2172;HOSPITAL GENERAL DE NIÑOS PEDRO DE ELIZALDE;
Cuidados Especiales;Cirugía Cardiovascular;124;32;156;110;15;125;30;155;3051;1424;834;389;4667;919;1859;968;2012;2172;HOSPITAL GENERAL DE NIÑOS PEDRO DE ELIZALDE;
Cuidados Especiales;Guardia;1771;0;1771;1034;3;1037;732;1769;2986;1931;816;528;6467;109;21683;17;2012;2172;HOSPITAL GENERAL DE NIÑOS PEDRO DE ELIZALDE;
Cuidados Especiales;Subtotal Cuidados Especiales;2412;546;2958;1496;80;1576;1368;2944;21794;13788;5955;3767;6327;468;4944;272;2012;2172;HOSPITAL GENERAL DE NIÑOS PEDRO DE ELIZALDE;
Cuidados Especiales;Total Hospital;8822;1879;10701;8723;82;8805;1879;10684;88044;57122;24056;15607;6488;649;366;93;2012;2172;HOSPITAL GENERAL DE NIÑOS PEDRO DE ELIZALDE;
Medicina;Pediatria;3257;477;3734;3305;7;3312;423;3735;36327;30458;9925;8322;8384;815;3763;19;2012;2164;HOSPITAL GENERAL DE NIÑOS RICARDO GUTIERREZ;
Medicina;Endocrinología;374;0;374;374;0;374;0;374;2196;363;6;99;1653;97;6233;0;2012;2164;HOSPITAL GENERAL DE NIÑOS RICARDO GUTIERREZ;
Medicina;Infecciosas;600;153;753;600;13;613;139;752;9969;8568;2724;2341;8595;1139;2761;173;2012;2164;HOSPITAL GENERAL DE NIÑOS RICARDO GUTIERREZ;
Medicina;Neonatología;299;18;317;279;18;297;20;317;6733;5762;184;1574;8558;1818;1723;568;2012;2164;HOSPITAL GENERAL DE NIÑOS RICARDO GUTIERREZ;
Medicina;Centro Respiratorio;179;82;261;176;0;176;76;252;3760;3262;1027;891;8676;1294;2453;0;2012;2164;HOSPITAL GENERAL DE NIÑOS RICARDO GUTIERREZ;
Medicina;Nefrología;292;17;309;288;1;289;18;307;4392;2421;12;661;5512;789;2558;33;2012;2164;HOSPITAL GENERAL DE NIÑOS RICARDO GUTIERREZ;
Medicina;Subtotal Medicina;5001;747;5748;5022;39;5061;676;5737;63377;50834;17316;13889;8021;886;3313;68;2012;2164;HOSPITAL GENERAL DE NIÑOS RICARDO GUTIERREZ;
Cirugia;Cirugía General;1871;466;2337;1852;3;1855;488;2343;13150;7251;3593;1981;5514;309;6521;13;2012;2164;HOSPITAL GENERAL DE NIÑOS RICARDO GUTIERREZ;
Cirugia;Cirugía Cardiovascular;248;20;268;222;27;249;24;273;5985;3957;1635;1081;6612;1449;1669;989;2012;2164;HOSPITAL GENERAL DE NIÑOS RICARDO GUTIERREZ;
Cirugia;Cirugía Plástica Y Reparadora - niÃ±os;534;36;570;528;0;528;42;570;3290;1736;899;474;5277;305;6341;0;2012;2164;HOSPITAL GENERAL DE NIÑOS RICARDO GUTIERREZ;
Cirugia;Neurocirugía;426;88;514;435;1;436;80;516;7326;3115;2002;851;4252;604;2578;19;2012;2164;HOSPITAL GENERAL DE NIÑOS RICARDO GUTIERREZ;
Cirugia;Ortopedia Y Traumatología;1242;121;1363;1249;0;1249;117;1366;13266;7737;3625;2114;5832;566;3769;0;2012;2164;HOSPITAL GENERAL DE NIÑOS RICARDO GUTIERREZ;
Cirugia;Urologia;308;9;317;307;0;307;8;315;4748;1707;1297;466;3595;542;2428;0;2012;2164;HOSPITAL GENERAL DE NIÑOS RICARDO GUTIERREZ;
Cirugia;Subtotal Cirugia;4629;740;5369;4593;31;4624;759;5383;47765;25503;13051;6968;5339;474;4125;58;2012;2164;HOSPITAL GENERAL DE NIÑOS RICARDO GUTIERREZ;
Urgencia;Terapia Intermedia;26;99;125;18;0;18;107;125;493;351;135;96;712;281;928;0;2012;2164;HOSPITAL GENERAL DE NIÑOS RICARDO GUTIERREZ;
Urgencia;Terapia Intensiva;108;187;295;4;64;68;232;300;5939;5056;1623;1381;8513;1685;1849;2133;2012;2164;HOSPITAL GENERAL DE NIÑOS RICARDO GUTIERREZ;
Urgencia;Subtotal Urgencia;134;286;420;22;64;86;339;425;6432;5407;1757;1477;8406;1272;2418;1506;2012;2164;HOSPITAL GENERAL DE NIÑOS RICARDO GUTIERREZ;
Urgencia;Total Hospital;9764;1773;11537;9637;134;9771;1774;11545;117574;81744;32124;22334;6953;837;3042;137;2012;2164;HOSPITAL GENERAL DE NIÑOS RICARDO GUTIERREZ;
Pediatria;Recien Nacido Sano;5261;528;5789;5220;0;5220;579;5799;25243;16124;6897;4405;6388;278;8408;0;2012;2167;HOSPITAL MATERNO INFANTIL R. SARDA;
Pediatria;Neonatología;1146;1094;2240;1126;77;1203;1040;2243;29609;15341;809;4192;5181;684;2773;343;2012;2167;HOSPITAL MATERNO INFANTIL R. SARDA;
Pediatria;Subtotal Pediatria;6407;1622;8029;6346;77;6423;1619;8042;54852;31465;14987;8597;5736;391;5366;96;2012;2167;HOSPITAL MATERNO INFANTIL R. SARDA;
Tocoginecologia;Tocoginecología;7854;159;8013;7920;0;7920;121;8041;37327;30601;10199;8361;8198;381;7884;0;2012;2167;HOSPITAL MATERNO INFANTIL R. SARDA;
Tocoginecologia;Subtotal Tocoginecologia;7854;159;8013;7920;0;7920;121;8041;37327;30601;10199;8361;8198;381;7884;0;2012;2167;HOSPITAL MATERNO INFANTIL R. SARDA;
Urgencia;Terapia Intermedia;23;38;61;40;0;40;19;59;1095;208;299;57;19;353;1972;0;2012;2167;HOSPITAL MATERNO INFANTIL R. SARDA;
Urgencia;Terapia Intensiva;70;29;99;11;0;11;89;100;1519;371;415;101;2442;371;2409;0;2012;2167;HOSPITAL MATERNO INFANTIL R. SARDA;
Urgencia;Subtotal Urgencia;93;67;160;51;0;51;108;159;2614;579;714;158;2215;364;2226;0;2012;2167;HOSPITAL MATERNO INFANTIL R. SARDA;
Urgencia;Total Hospital;14354;1848;16202;14317;77;14394;1848;16242;94793;62645;259;17116;6609;435;5558;53;2012;2167;HOSPITAL MATERNO INFANTIL R. SARDA;
Medicina;Dermatología;384;18;402;357;1;358;44;402;12208;7723;3336;211;6326;1921;1205;25;2012;2110;HOSPITAL DE INFECCIOSAS F. MUÑIZ;
Medicina;Infecciosas;1260;247;1507;1194;85;1279;208;1487;34828;27722;9516;7574;796;1864;1563;572;2012;2110;HOSPITAL DE INFECCIOSAS F. MUÑIZ;
Medicina;Hepatopatía;259;26;285;231;10;241;42;283;4694;2281;1283;623;4859;806;2207;353;2012;2110;HOSPITAL DE INFECCIOSAS F. MUÑIZ;
Medicina;Neumotisiología;227;51;278;270;6;276;35;311;11721;9509;3202;2598;8113;3058;971;193;2012;2110;HOSPITAL DE INFECCIOSAS F. MUÑIZ;
Medicina;Asistencia Respiratoria Intermedia;226;311;537;128;98;226;313;539;5438;3661;1486;10;6732;679;3628;1818;2012;2110;HOSPITAL DE INFECCIOSAS F. MUÑIZ;
Medicina;Zoopatología Médica;309;79;388;311;7;318;79;397;5694;4104;1556;1121;7208;1034;2552;176;2012;2110;HOSPITAL DE INFECCIOSAS F. MUÑIZ;
Medicina;Subtotal Medicina;2665;732;3397;2491;207;2698;721;3419;74583;55000;20378;15027;7374;1609;1678;605;2012;2110;HOSPITAL DE INFECCIOSAS F. MUÑIZ;
Cirugia;Cirugía General;542;58;600;533;4;537;66;603;7298;2887;1994;789;3956;479;3024;66;2012;2110;HOSPITAL DE INFECCIOSAS F. MUÑIZ;
Cirugia;Subtotal Cirugia;542;58;600;533;4;537;66;603;7298;2887;1994;789;3956;479;3024;66;2012;2110;HOSPITAL DE INFECCIOSAS F. MUÑIZ;
Pediatria;Infecciosas Pediatría;488;10;498;493;0;493;10;503;10779;5233;2945;143;4855;104;1708;0;2012;2110;HOSPITAL DE INFECCIOSAS F. MUÑIZ;
Pediatria;Subtotal Pediatria;488;10;498;493;0;493;10;503;10779;5233;2945;143;4855;104;1708;0;2012;2110;HOSPITAL DE INFECCIOSAS F. MUÑIZ;
Urgencia;Terapia Intensiva;112;136;248;26;82;108;139;247;2360;1731;645;473;7335;701;3831;332;2012;2110;HOSPITAL DE INFECCIOSAS F. MUÑIZ;
Urgencia;Subtotal Urgencia;112;136;248;26;82;108;139;247;2360;1731;645;473;7335;701;3831;332;2012;2110;HOSPITAL DE INFECCIOSAS F. MUÑIZ;
Urgencia;Total Hospital;3807;936;4743;3543;293;3836;936;4772;95020;64851;25962;17719;6825;1691;1478;764;2012;2110;HOSPITAL DE INFECCIOSAS F. MUÑIZ;
Medicina;Curieterapia;90;1;91;87;0;87;4;91;1005;339;275;93;3373;373;3314;0;2012;2168;HOSPITAL MUNICIPAL DE ONCOLOGIA MARIE CURIE;
Medicina;Medicina;1590;27;1617;1205;377;1582;49;1631;19851;16059;5424;4388;809;985;3007;2311;2012;2168;HOSPITAL MUNICIPAL DE ONCOLOGIA MARIE CURIE;
Medicina;Subtotal Medicina;1680;28;1708;1292;377;1669;53;1722;20856;16398;5698;448;7862;952;3022;2189;2012;2168;HOSPITAL MUNICIPAL DE ONCOLOGIA MARIE CURIE;
Cirugia;Cirugía General;760;49;809;771;11;782;24;806;10337;3836;2824;1048;3711;476;2854;136;2012;2168;HOSPITAL MUNICIPAL DE ONCOLOGIA MARIE CURIE;
Cirugia;Subtotal Cirugia;760;49;809;771;11;782;24;806;10337;3836;2824;1048;3711;476;2854;136;2012;2168;HOSPITAL MUNICIPAL DE ONCOLOGIA MARIE CURIE;
Cirugia;Total Hospital;2440;77;2517;2063;388;2451;77;2528;31193;20234;8523;5528;6487;826;2876;1583;2012;2168;HOSPITAL MUNICIPAL DE ONCOLOGIA MARIE CURIE;
Cirugia;Cirugía Plástica;538;8;546;536;0;536;10;546;3294;771;9;211;2341;141;6067;0;2012;2112;HOSPITAL DE QUEMADOS DR. ARTURO UMBERTO ILLIA;
Cirugia;Quemados ;10;146;156;91;0;91;66;157;3604;3353;985;916;9304;2136;1594;0;2012;2112;HOSPITAL DE QUEMADOS DR. ARTURO UMBERTO ILLIA;
Cirugia;Quemados - Cuidados Generales - Adultos;62;200;262;220;0;220;39;259;4513;3007;1233;822;6663;1161;21;0;2012;2112;HOSPITAL DE QUEMADOS DR. ARTURO UMBERTO ILLIA;
Cirugia;Quemados - Cuidados Intemedios - Adultos;0;2;2;0;0;0;1;1;11;11;3;3;100;11;3327;0;2012;2112;HOSPITAL DE QUEMADOS DR. ARTURO UMBERTO ILLIA;
Cirugia;Subtotal Cirugia;610;356;966;847;0;847;116;963;11422;7142;3121;1951;6253;742;3086;0;2012;2112;HOSPITAL DE QUEMADOS DR. ARTURO UMBERTO ILLIA;
Pediatria;Quemados ;61;228;289;148;0;148;140;288;4542;3042;1241;831;6697;1056;2321;0;2012;2112;HOSPITAL DE QUEMADOS DR. ARTURO UMBERTO ILLIA;
Pediatria;Quemados - Cuidados Generales - Pediatría;23;151;174;160;0;160;11;171;2818;1467;77;401;5206;858;2221;0;2012;2112;HOSPITAL DE QUEMADOS DR. ARTURO UMBERTO ILLIA;
Pediatria;Subtotal Pediatria;84;379;463;308;0;308;151;459;7360;4509;2011;1232;6126;982;2283;0;2012;2112;HOSPITAL DE QUEMADOS DR. ARTURO UMBERTO ILLIA;
Urgencia;Guardia;612;2;614;114;1;115;499;614;1095;260;299;71;2374;42;20523;16;2012;2112;HOSPITAL DE QUEMADOS DR. ARTURO UMBERTO ILLIA;
Urgencia;Quemados Cuidados Intensivos - Adultos;1;80;81;5;25;30;51;81;1824;1658;498;453;909;2047;1625;3086;2012;2112;HOSPITAL DE QUEMADOS DR. ARTURO UMBERTO ILLIA;
Urgencia;Subtotal Urgencia;613;82;695;119;26;145;550;695;2919;1918;798;524;6571;276;8714;374;2012;2112;HOSPITAL DE QUEMADOS DR. ARTURO UMBERTO ILLIA;
Internacion De Corta Estadia;Cirugia De Corta Estadia;41;0;41;41;0;41;0;41;1830;41;5;11;224;1;82;0;2012;2112;HOSPITAL DE QUEMADOS DR. ARTURO UMBERTO ILLIA;
Internacion De Corta Estadia;Subtotal Internacion De Corta Estadia;41;0;41;41;0;41;0;41;1830;0;5;11;224;1;82;0;2012;2112;HOSPITAL DE QUEMADOS DR. ARTURO UMBERTO ILLIA;
Internacion De Corta Estadia;Total Hospital;1348;817;2165;1315;26;1341;817;2158;23531;13610;6429;3719;5784;1015;2086;194;2012;2112;HOSPITAL DE QUEMADOS DR. ARTURO UMBERTO ILLIA;
Medicina;Hepatología;71;6;77;48;5;53;22;75;1466;1025;401;28;6992;1367;1872;667;2012;2109;HOSPITAL DE GASTROENTEROLOGIA B. UDAONDO;
Medicina;Clínica Médica;982;99;1081;764;43;807;278;1085;13908;11025;38;3012;7927;1016;2855;396;2012;2109;HOSPITAL DE GASTROENTEROLOGIA B. UDAONDO;
Medicina;Subtotal Medicina;1053;105;1158;812;48;860;300;1160;15374;12050;4201;3292;7838;1039;2762;414;2012;2109;HOSPITAL DE GASTROENTEROLOGIA B. UDAONDO;
Cirugia;Cirugía;1054;375;1429;1332;7;1339;148;1487;10886;7727;2974;2111;7098;52;4999;47;2012;2109;HOSPITAL DE GASTROENTEROLOGIA B. UDAONDO;
Cirugia;Subtotal Cirugia;1054;375;1429;1332;7;1339;148;1487;10886;7727;2974;2111;7098;52;4999;47;2012;2109;HOSPITAL DE GASTROENTEROLOGIA B. UDAONDO;
Urgencia;Terapia Intensiva;83;159;242;5;45;50;191;241;2518;1722;688;47;6839;715;3503;1867;2012;2109;HOSPITAL DE GASTROENTEROLOGIA B. UDAONDO;
Urgencia;Subtotal Urgencia;83;159;242;5;45;50;191;241;2518;1722;688;47;6839;715;3503;1867;2012;2109;HOSPITAL DE GASTROENTEROLOGIA B. UDAONDO;
Urgencia;Total Hospital;2190;639;2829;2149;100;2249;639;2888;28778;21499;7863;5874;7471;956;286;445;2012;2109;HOSPITAL DE GASTROENTEROLOGIA B. UDAONDO;
Cirugia;Oftalmología;3487;0;3487;3488;0;3488;0;3488;14640;4169;40;1139;2848;12;872;0;2012;2169;HOSPITAL OFTALMOLOGICO DR. PEDRO LAGLEYZE;
Cirugia;Subtotal Cirugia;3487;0;3487;3488;0;3488;0;3488;14640;4169;40;1139;2848;12;872;0;2012;2169;HOSPITAL OFTALMOLOGICO DR. PEDRO LAGLEYZE;
Cirugia;Total Hospital;3487;0;3487;3488;0;3488;0;3488;14640;4169;40;1139;2848;12;872;0;2012;2169;HOSPITAL OFTALMOLOGICO DR. PEDRO LAGLEYZE;
Cirugia;Neurocirugía;20;8;28;21;0;21;8;29;6588;150;18;41;228;517;161;0;2012;2111;HOSPITAL DE OFTALMOLOGIA SANTA LUCIA;
Cirugia;Oftalmología;3525;2;3527;3504;0;3504;0;3504;11712;2995;32;818;2557;85;1095;0;2012;2111;HOSPITAL DE OFTALMOLOGIA SANTA LUCIA;
Cirugia;Subtotal Cirugia;3545;10;3555;3525;0;3525;8;3533;18300;3145;50;859;1719;89;7066;0;2012;2111;HOSPITAL DE OFTALMOLOGIA SANTA LUCIA;
Urgencia;Terapia Intensiva;2;6;8;0;0;0;8;8;1098;18;3;5;164;225;267;0;2012;2111;HOSPITAL DE OFTALMOLOGIA SANTA LUCIA;
Urgencia;Subtotal Urgencia;2;6;8;0;0;0;8;8;1098;18;3;5;164;225;267;0;2012;2111;HOSPITAL DE OFTALMOLOGIA SANTA LUCIA;
Urgencia;Total Hospital;3547;16;3563;3525;0;3525;16;3541;19398;3163;53;864;1631;9;6651;0;2012;2111;HOSPITAL DE OFTALMOLOGIA SANTA LUCIA;
Medicina;Clínica Médica;0;152;152;32;4;36;105;141;11712;9547;32;2608;8151;6771;441;284;2012;2117;HOSPITAL DE SALUD MENTAL J. T. BORDA;
Medicina;Neurología;0;12;12;0;0;0;13;13;5124;3305;14;903;645;25423;93;0;2012;2117;HOSPITAL DE SALUD MENTAL J. T. BORDA;
Medicina;Psicopatologia Y Salud Mental;915;905;1820;906;11;917;948;1865;273379;234169;74694;63981;8566;12556;25;59;2012;2117;HOSPITAL DE SALUD MENTAL J. T. BORDA;
Medicina;Subtotal Medicina;915;1069;1984;938;15;953;1066;2019;290215;247021;79294;67492;8512;12235;255;74;2012;2117;HOSPITAL DE SALUD MENTAL J. T. BORDA;
Cirugia;Cirugía General;0;28;28;4;1;5;31;36;3660;3482;10;951;9514;9672;36;278;2012;2117;HOSPITAL DE SALUD MENTAL J. T. BORDA;
Cirugia;Subtotal Cirugia;0;28;28;4;1;5;31;36;3660;3482;10;951;9514;9672;36;278;2012;2117;HOSPITAL DE SALUD MENTAL J. T. BORDA;
Cirugia;Total Hospital;915;1097;2012;942;16;958;1097;2055;293875;250503;80294;68443;8524;26149;119;167;2012;2117;HOSPITAL DE SALUD MENTAL J. T. BORDA;
Medicina;Clínica Médica;0;54;54;4;9;13;42;55;8418;5052;23;138;6001;9185;239;1636;2012;2116;HOSPITAL DE SALUD MENTAL BRAULIO MOYANO;
Medicina;Psicopatologia Y Salud Mental;1094;1035;2129;1067;21;1088;1060;2148;327088;301837;89368;82469;9228;14052;24;98;2012;2116;HOSPITAL DE SALUD MENTAL BRAULIO MOYANO;
Medicina;Subtotal Medicina;1094;1089;2183;1071;30;1101;1102;2203;335506;306889;91668;83849;9147;13931;24;136;2012;2116;HOSPITAL DE SALUD MENTAL BRAULIO MOYANO;
Cirugia;Cirugía General;0;59;59;6;3;9;51;60;5856;2589;16;707;4421;4315;375;5;2012;2116;HOSPITAL DE SALUD MENTAL BRAULIO MOYANO;
Cirugia;Ginecología;0;12;12;4;1;5;7;12;5856;260;16;71;444;2167;75;833;2012;2116;HOSPITAL DE SALUD MENTAL BRAULIO MOYANO;
Cirugia;Subtotal Cirugia;0;71;71;10;4;14;58;72;11712;2849;32;778;2433;3957;225;556;2012;2116;HOSPITAL DE SALUD MENTAL BRAULIO MOYANO;
Cirugia;Total Hospital;1094;1160;2254;1081;34;1115;1160;2275;347218;309738;94868;84628;8921;27779;118;305;2012;2116;HOSPITAL DE SALUD MENTAL BRAULIO MOYANO;
Pediatria;Psiquiatria;333;38;371;357;0;357;38;395;22307;14864;6095;4061;6663;3763;648;0;2012;2165;HOSPITAL INFANTO JUVENIL C. TOBAR GARCIA;
Pediatria;Subtotal Pediatria;333;38;371;357;0;357;38;395;22307;14864;6095;4061;6663;3763;648;0;2012;2165;HOSPITAL INFANTO JUVENIL C. TOBAR GARCIA;
Pediatria;Total Hospital;333;38;371;357;0;357;38;395;22307;14864;6095;4061;6663;4164;586;0;2012;2165;HOSPITAL INFANTO JUVENIL C. TOBAR GARCIA;
Medicina;Psicopatologia Y Salud Mental;15;297;312;277;0;277;34;311;18307;17825;5002;487;9737;5732;622;0;2012;2108;HOSPITAL DE EMERGENCIAS PSIQUIATRICAS TORCUATO DE ALVEAR;
Medicina;Adolescencia;31;58;89;84;0;84;10;94;6617;5792;1808;1583;8753;6162;52;0;2012;2108;HOSPITAL DE EMERGENCIAS PSIQUIATRICAS TORCUATO DE ALVEAR;
Medicina;Subtotal Medicina;46;355;401;361;0;361;44;405;24924;23617;681;6453;9476;5831;595;0;2012;2108;HOSPITAL DE EMERGENCIAS PSIQUIATRICAS TORCUATO DE ALVEAR;
Urgencia;Emergencia;457;44;501;145;0;145;355;500;5973;5620;1632;1536;9409;1124;3064;0;2012;2108;HOSPITAL DE EMERGENCIAS PSIQUIATRICAS TORCUATO DE ALVEAR;
Urgencia;Subtotal Urgencia;457;44;501;145;0;145;355;500;5973;5620;1632;1536;9409;1124;3064;0;2012;2108;HOSPITAL DE EMERGENCIAS PSIQUIATRICAS TORCUATO DE ALVEAR;
Urgencia;Total Hospital;503;399;902;506;0;506;399;905;30897;29237;8442;7988;9463;5778;599;0;2012;2108;HOSPITAL DE EMERGENCIAS PSIQUIATRICAS TORCUATO DE ALVEAR;
Medicina;Fisiatría;98;3;101;100;1;101;3;104;26245;19872;7171;543;7572;19108;145;96;2012;2113;HOSPITAL DE REHABILITACION M. ROCCA;
Medicina;Subtotal Medicina;98;3;101;100;1;101;3;104;26245;19872;7171;543;7572;19108;145;96;2012;2113;HOSPITAL DE REHABILITACION M. ROCCA;
Cirugia;Cirugía General;90;0;90;90;0;90;0;90;2256;1162;616;317;5151;1291;146;0;2012;2113;HOSPITAL DE REHABILITACION M. ROCCA;
Cirugia;Subtotal Cirugia;90;0;90;90;0;90;0;90;2256;1162;616;317;5151;1291;146;0;2012;2113;HOSPITAL DE REHABILITACION M. ROCCA;
Cirugia;Total Hospital;188;3;191;190;1;191;3;194;28501;21034;7787;5747;738;11013;245;52;2012;2113;HOSPITAL DE REHABILITACION M. ROCCA;
Medicina;Fisiatría;103;11;114;106;0;106;9;115;16050;6560;4385;1792;4087;5704;262;0;2012;2114;INSTITUTO DE REHABILITACION PSICOFISICA (I.R.E.P.);
Medicina;Subtotal Medicina;103;11;114;106;0;106;9;115;16050;6560;4385;1792;4087;5704;262;0;2012;2114;INSTITUTO DE REHABILITACION PSICOFISICA (I.R.E.P.);
Cirugia;Cirugía General;528;7;535;524;0;524;9;533;6234;2226;1703;608;3571;418;3129;0;2012;2114;INSTITUTO DE REHABILITACION PSICOFISICA (I.R.E.P.);
Cirugia;Subtotal Cirugia;528;7;535;524;0;524;9;533;6234;2226;1703;608;3571;418;3129;0;2012;2114;INSTITUTO DE REHABILITACION PSICOFISICA (I.R.E.P.);
Cirugia;Total Hospital;631;18;649;630;0;630;18;648;22284;8786;6089;2401;3943;1395;1035;0;2012;2114;INSTITUTO DE REHABILITACION PSICOFISICA (I.R.E.P.);
Medicina;Terapia Prolongada;678;44;722;570;14;584;138;722;2957;1880;808;514;6358;26;8936;194;2012;2115;HOSPITAL DE REHABILITACION RESPIRATORIA MARIA FERRER;
Medicina;Terapia Intermedia;620;249;869;713;26;739;126;865;7134;6004;1949;164;8416;694;4438;301;2012;2115;HOSPITAL DE REHABILITACION RESPIRATORIA MARIA FERRER;
Medicina;Subtotal Medicina;1298;293;1591;1283;40;1323;264;1587;10091;7884;2757;2154;7813;497;5756;252;2012;2115;HOSPITAL DE REHABILITACION RESPIRATORIA MARIA FERRER;
Urgencia;Terapia Intensiva;136;201;337;61;41;102;230;332;2832;2232;774;61;7881;672;4291;1235;2012;2115;HOSPITAL DE REHABILITACION RESPIRATORIA MARIA FERRER;
Urgencia;Subtotal Urgencia;136;201;337;61;41;102;230;332;2832;2232;774;61;7881;672;4291;1235;2012;2115;HOSPITAL DE REHABILITACION RESPIRATORIA MARIA FERRER;
Urgencia;Total Hospital;1434;494;1928;1344;81;1425;494;1919;12923;10116;3531;2764;7828;71;4036;568;2012;2115;HOSPITAL DE REHABILITACION RESPIRATORIA MARIA FERRER;
Medicina;Cardiología;30;231;261;157;13;170;89;259;3670;1451;1005;398;3954;56;2576;502;2013;2126;HOSPITAL GENERAL DE AGUDOS DR. T. ALVAREZ;
Medicina;Clínica Médica;265;896;1161;909;111;1020;140;1160;18003;15120;4932;4142;8399;1303;2352;957;2013;2126;HOSPITAL GENERAL DE AGUDOS DR. T. ALVAREZ;
Medicina;Neurología;6;17;23;18;2;20;2;22;368;312;101;85;8478;1418;2182;909;2013;2126;HOSPITAL GENERAL DE AGUDOS DR. T. ALVAREZ;
Medicina;Psicopatologia Y Salud Mental;12;49;61;61;0;61;5;66;6689;5492;1833;1505;821;8321;36;0;2013;2126;HOSPITAL GENERAL DE AGUDOS DR. T. ALVAREZ;
Medicina;Unidad Coronaria;75;172;247;112;22;134;115;249;1851;1303;507;357;7039;523;491;884;2013;2126;HOSPITAL GENERAL DE AGUDOS DR. T. ALVAREZ;
Medicina;Subtotal Medicina;388;1365;1753;1257;148;1405;351;1756;30581;23678;8378;6487;7743;1348;2096;843;2013;2126;HOSPITAL GENERAL DE AGUDOS DR. T. ALVAREZ;
Cirugia;Cirugía General;444;445;889;749;7;756;117;873;8148;6096;2232;167;7482;698;3911;8;2013;2126;HOSPITAL GENERAL DE AGUDOS DR. T. ALVAREZ;
Cirugia;Ginecología;202;33;235;220;0;220;18;238;1468;959;402;263;6533;403;5918;0;2013;2126;HOSPITAL GENERAL DE AGUDOS DR. T. ALVAREZ;
Cirugia;Ortopedia Y Traumatología;266;188;454;391;9;400;52;452;8074;5114;2212;1401;6334;1131;2043;199;2013;2126;HOSPITAL GENERAL DE AGUDOS DR. T. ALVAREZ;
Cirugia;Urología;86;7;93;85;0;85;8;93;734;299;201;82;4074;322;4625;0;2013;2126;HOSPITAL GENERAL DE AGUDOS DR. T. ALVAREZ;
Cirugia;Subtotal Cirugia;998;673;1671;1445;16;1461;195;1656;18424;12468;5048;3416;6767;753;3281;97;2013;2126;HOSPITAL GENERAL DE AGUDOS DR. T. ALVAREZ;
Pediatria;Recien Nacido Sano;1302;338;1640;1516;0;1516;120;1636;6246;3934;1711;1078;6298;24;956;0;2013;2126;HOSPITAL GENERAL DE AGUDOS DR. T. ALVAREZ;
Pediatria;Neonatología;467;120;587;243;6;249;338;587;3483;2700;954;74;7752;46;6151;102;2013;2126;HOSPITAL GENERAL DE AGUDOS DR. T. ALVAREZ;
Pediatria;Pediatría;1064;0;1064;1066;0;1066;0;1066;6693;3330;1834;912;4975;312;5813;0;2013;2126;HOSPITAL GENERAL DE AGUDOS DR. T. ALVAREZ;
Pediatria;Subtotal Pediatria;2833;458;3291;2825;6;2831;458;3289;16422;9964;4499;273;6067;303;731;18;2013;2126;HOSPITAL GENERAL DE AGUDOS DR. T. ALVAREZ;
Urgencia;Subtotal Urgencia;103;145;248;16;88;104;142;246;2267;1655;621;453;73;673;3961;3577;2013;2110;HOSPITAL DE INFECCIOSAS F. MUÑIZ;
Urgencia;Total Hospital;4093;1043;5136;3782;284;4066;1043;5109;108990;66514;2986;18223;6103;1636;1362;698;2013;2110;HOSPITAL DE INFECCIOSAS F. MUÑIZ;
Medicina;Curieterapia;87;2;89;86;0;86;3;89;952;329;261;9;3456;37;3412;0;2013;2168;HOSPITAL MUNICIPAL DE ONCOLOGIA MARIE CURIE;
Medicina;Medicina;1590;22;1612;1139;419;1558;39;1597;19328;16483;5295;4516;8528;1032;3016;2624;2013;2168;HOSPITAL MUNICIPAL DE ONCOLOGIA MARIE CURIE;
Medicina;Subtotal Medicina;1677;24;1701;1225;419;1644;42;1686;20280;16812;5556;4606;829;997;3034;2485;2013;2168;HOSPITAL MUNICIPAL DE ONCOLOGIA MARIE CURIE;
Cirugia;Cirugía General;635;37;672;643;9;652;19;671;9543;3276;2615;898;3433;488;2566;134;2013;2168;HOSPITAL MUNICIPAL DE ONCOLOGIA MARIE CURIE;
Cirugia;Subtotal Cirugia;635;37;672;643;9;652;19;671;9543;3276;2615;898;3433;488;2566;134;2013;2168;HOSPITAL MUNICIPAL DE ONCOLOGIA MARIE CURIE;
Cirugia;Total Hospital;2312;61;2373;1868;428;2296;61;2357;29823;20088;8171;5504;6736;875;281;1864;2013;2168;HOSPITAL MUNICIPAL DE ONCOLOGIA MARIE CURIE;
Cirugia;Cirugía Plástica;533;32;565;540;0;540;25;565;3285;0;9;241;2679;156;6278;0;2013;2112;HOSPITAL DE QUEMADOS DR. ARTURO UMBERTO ILLIA;
Cirugia;Quemados ;9;148;157;103;2;105;53;158;3777;0;1035;949;9169;2192;1527;127;2013;2112;HOSPITAL DE QUEMADOS DR. ARTURO UMBERTO ILLIA;
Cirugia;Quemados - Cuidados Generales - Adultos;43;180;223;178;0;178;43;221;4430;0;1214;733;6036;121;1821;0;2013;2112;HOSPITAL DE QUEMADOS DR. ARTURO UMBERTO ILLIA;
Cirugia;Subtotal Cirugia;585;360;945;821;2;823;121;944;11492;7017;3148;1922;6106;743;2998;21;2013;2112;HOSPITAL DE QUEMADOS DR. ARTURO UMBERTO ILLIA;
Pediatria;Quemados ;73;284;357;250;0;250;103;353;4826;4134;1322;1133;8566;1171;267;0;2013;2112;HOSPITAL DE QUEMADOS DR. ARTURO UMBERTO ILLIA;
Pediatria;Quemados - Cuidados Generales - Pediatría;25;103;128;115;0;115;16;131;2550;1120;699;307;4392;855;1875;0;2013;2112;HOSPITAL DE QUEMADOS DR. ARTURO UMBERTO ILLIA;
Pediatria;Subtotal Pediatria;98;387;485;365;0;365;119;484;7376;5254;2021;1439;7123;1086;2395;0;2013;2112;HOSPITAL DE QUEMADOS DR. ARTURO UMBERTO ILLIA;
Urgencia;Guardia;609;1;610;62;0;62;548;610;1095;194;3;53;1772;32;20333;0;2013;2112;HOSPITAL DE QUEMADOS DR. ARTURO UMBERTO ILLIA;
Urgencia;Quemados Cuidados Intensivos - Adultos;1;90;91;5;33;38;55;93;2169;1799;594;493;8294;1934;1565;3548;2013;2112;HOSPITAL DE QUEMADOS DR. ARTURO UMBERTO ILLIA;
Urgencia;Terapia Intensiva;0;6;6;1;1;2;0;2;180;112;49;31;6222;56;406;50;2013;2112;HOSPITAL DE QUEMADOS DR. ARTURO UMBERTO ILLIA;
Urgencia;Subtotal Urgencia;610;97;707;68;34;102;603;705;3444;2105;944;577;6112;299;7472;482;2013;2112;HOSPITAL DE QUEMADOS DR. ARTURO UMBERTO ILLIA;
Internacion De Corta Estadia;Cirugia De Corta Estadia;52;0;52;51;0;51;1;52;1219;0;334;14;418;98;1557;0;2013;2112;HOSPITAL DE QUEMADOS DR. ARTURO UMBERTO ILLIA;
Internacion De Corta Estadia;Subtotal Internacion De Corta Estadia;52;0;52;51;0;51;1;52;1219;0;334;14;418;98;1557;0;2013;2112;HOSPITAL DE QUEMADOS DR. ARTURO UMBERTO ILLIA;
Internacion De Corta Estadia;Total Hospital;1345;844;2189;1305;36;1341;844;2185;23531;14427;6447;3953;6131;1076;208;268;2013;2112;HOSPITAL DE QUEMADOS DR. ARTURO UMBERTO ILLIA;
Medicina;Hepatología;74;4;78;42;7;49;30;79;1460;993;4;0;2;72;68;1;2013;2109;HOSPITAL DE GASTROENTEROLOGIA B. UDAONDO;
Medicina;Clínica Médica;1061;85;1146;787;70;857;290;1147;13870;11608;38;0;31;80;83;69;2013;2109;HOSPITAL DE GASTROENTEROLOGIA B. UDAONDO;
Medicina;Subtotal Medicina;1135;89;1224;829;77;906;320;1226;15330;12601;42;0;34;52;82;20;2013;2109;HOSPITAL DE GASTROENTEROLOGIA B. UDAONDO;
Cirugia;Cirugía;1201;386;1587;1417;3;1420;146;1566;11703;7839;32;6;21;48;66;98;2013;2109;HOSPITAL DE GASTROENTEROLOGIA B. UDAONDO;
Cirugia;Subtotal Cirugia;1201;386;1587;1417;3;1420;146;1566;11703;7839;32;6;21;48;66;98;2013;2109;HOSPITAL DE GASTROENTEROLOGIA B. UDAONDO;
Urgencia;Terapia Intensiva;84;171;255;9;58;67;180;247;2338;1649;6;41;4;52;70;53;2013;2109;HOSPITAL DE GASTROENTEROLOGIA B. UDAONDO;
Urgencia;Subtotal Urgencia;84;171;255;9;58;67;180;247;2338;1649;6;41;4;52;70;53;2013;2109;HOSPITAL DE GASTROENTEROLOGIA B. UDAONDO;
Urgencia;Total Hospital;2420;646;3066;2255;138;2393;646;3039;29371;22089;80;47;60;52;75;21;2013;2109;HOSPITAL DE GASTROENTEROLOGIA B. UDAONDO;
Cirugia;Oftalmología;3101;0;3101;3102;0;3102;0;3102;14600;3773;40;1034;2584;122;7755;0;2013;2169;HOSPITAL OFTALMOLOGICO DR. PEDRO LAGLEYZE;
Cirugia;Subtotal Cirugia;3101;0;3101;3102;0;3102;0;3102;14600;3773;40;1034;2584;122;7755;0;2013;2169;HOSPITAL OFTALMOLOGICO DR. PEDRO LAGLEYZE;
Cirugia;Total Hospital;3101;0;3101;3102;0;3102;0;3102;14600;3773;40;1034;2584;122;7755;0;2013;2169;HOSPITAL OFTALMOLOGICO DR. PEDRO LAGLEYZE;
Cirugia;Neurocirugía;2;1;3;2;0;2;1;3;6552;0;1795;2;11;233;17;0;2013;2111;HOSPITAL DE OFTALMOLOGIA SANTA LUCIA;
Cirugia;Oftalmología;4219;0;4219;4146;0;4146;0;4146;11648;2572;3191;705;2208;62;12992;0;2013;2111;HOSPITAL DE OFTALMOLOGIA SANTA LUCIA;
Cirugia;Subtotal Cirugia;4221;1;4222;4148;0;4148;1;4149;18200;2579;4986;707;1417;62;8321;0;2013;2111;HOSPITAL DE OFTALMOLOGIA SANTA LUCIA;
Urgencia;Terapia Intensiva;0;1;1;0;0;0;1;1;1092;6;299;2;55;6;33;0;2013;2111;HOSPITAL DE OFTALMOLOGIA SANTA LUCIA;
Urgencia;Subtotal Urgencia;0;1;1;0;0;0;1;1;1092;6;299;2;55;6;33;0;2013;2111;HOSPITAL DE OFTALMOLOGIA SANTA LUCIA;
Urgencia;Total Hospital;4221;2;4223;4148;0;4148;2;4150;19292;2585;5285;708;134;62;7848;0;2013;2111;HOSPITAL DE OFTALMOLOGIA SANTA LUCIA;
Medicina;Clínica Médica;0;229;229;37;5;42;73;115;11680;8122;32;2225;6954;7063;359;435;2013;2117;HOSPITAL DE SALUD MENTAL J. T. BORDA;
Medicina;Neurología;0;12;12;2;1;3;8;11;5110;2794;14;765;5468;254;79;909;2013;2117;HOSPITAL DE SALUD MENTAL J. T. BORDA;
Medicina;Psicopatologia Y Salud Mental;762;819;1581;752;3;755;996;1751;264995;219354;72601;60097;8278;12527;241;17;2013;2117;HOSPITAL DE SALUD MENTAL J. T. BORDA;
Medicina;Subtotal Medicina;762;1060;1822;791;9;800;1077;1877;281785;230270;77201;63088;8172;12268;243;48;2013;2117;HOSPITAL DE SALUD MENTAL J. T. BORDA;
Cirugia;Cirugía General;0;38;38;16;1;17;21;38;3650;2770;10;759;7589;7289;38;263;2013;2117;HOSPITAL DE SALUD MENTAL J. T. BORDA;
Cirugia;Subtotal Cirugia;0;38;38;16;1;17;21;38;3650;2770;10;759;7589;7289;38;263;2013;2117;HOSPITAL DE SALUD MENTAL J. T. BORDA;
Cirugia;Total Hospital;762;1098;1860;807;10;817;1098;1915;285435;233040;78201;63847;8164;28524;104;122;2013;2117;HOSPITAL DE SALUD MENTAL J. T. BORDA;
Medicina;Clínica Médica;0;23;23;6;8;14;11;25;8395;3795;23;104;4521;1518;109;32;2013;2116;HOSPITAL DE SALUD MENTAL BRAULIO MOYANO;
Medicina;Psicopatologia Y Salud Mental;1072;917;1989;1077;9;1086;945;2031;322181;294398;88269;80657;9138;14495;23;44;2013;2116;HOSPITAL DE SALUD MENTAL BRAULIO MOYANO;
Medicina;Subtotal Medicina;1072;940;2012;1083;17;1100;956;2056;330576;298193;90569;81697;902;14504;227;83;2013;2116;HOSPITAL DE SALUD MENTAL BRAULIO MOYANO;
Cirugia;Cirugía General;0;64;64;11;3;14;49;63;5840;2284;16;626;3911;3625;394;476;2013;2116;HOSPITAL DE SALUD MENTAL BRAULIO MOYANO;
Cirugia;Ginecología;0;9;9;0;0;0;8;8;5840;93;16;25;159;1163;5;0;2013;2116;HOSPITAL DE SALUD MENTAL BRAULIO MOYANO;
Cirugia;Subtotal Cirugia;0;73;73;11;3;14;57;71;11680;2377;32;651;2035;3348;222;423;2013;2116;HOSPITAL DE SALUD MENTAL BRAULIO MOYANO;
Cirugia;Total Hospital;1072;1013;2085;1094;20;1114;1013;2127;342256;300570;93769;82348;8782;26981;119;18;2013;2116;HOSPITAL DE SALUD MENTAL BRAULIO MOYANO;
Pediatria;Psiquiatria;265;22;287;267;0;267;22;289;16261;10561;4455;2893;6495;3654;649;0;2013;2165;HOSPITAL INFANTO JUVENIL C. TOBAR GARCIA;
Pediatria;Subtotal Pediatria;265;22;287;267;0;267;22;289;16261;10561;4455;2893;6495;3654;649;0;2013;2165;HOSPITAL INFANTO JUVENIL C. TOBAR GARCIA;
Pediatria;Total Hospital;265;22;287;267;0;267;22;289;16261;10561;4455;2893;6495;3955;599;0;2013;2165;HOSPITAL INFANTO JUVENIL C. TOBAR GARCIA;
Medicina;Psicopatologia Y Salud Mental;26;263;289;252;0;252;36;288;18302;17799;50;14;48;76;97;25;2013;2108;HOSPITAL DE EMERGENCIAS PSIQUIATRICAS TORCUATO DE ALVEAR;
Medicina;Adolescencia;20;39;59;43;0;43;16;59;6570;4430;18;0;12;14;67;43;2013;2108;HOSPITAL DE EMERGENCIAS PSIQUIATRICAS TORCUATO DE ALVEAR;
Medicina;Subtotal Medicina;46;302;348;295;0;295;52;347;24872;22229;68;14;60;9;89;37;2013;2108;HOSPITAL DE EMERGENCIAS PSIQUIATRICAS TORCUATO DE ALVEAR;
Urgencia;Emergencia;408;53;461;158;0;158;302;460;6037;5708;16;54;15;64;94;55;2013;2108;HOSPITAL DE EMERGENCIAS PSIQUIATRICAS TORCUATO DE ALVEAR;
Urgencia;Subtotal Urgencia;408;53;461;158;0;158;302;460;6037;5708;16;54;15;64;94;55;2013;2108;HOSPITAL DE EMERGENCIAS PSIQUIATRICAS TORCUATO DE ALVEAR;
Urgencia;Total Hospital;454;355;809;453;0;453;354;807;30909;27937;84;68;76;54;90;38;2013;2108;HOSPITAL DE EMERGENCIAS PSIQUIATRICAS TORCUATO DE ALVEAR;
Medicina;Fisiatría;83;2;85;76;1;77;4;81;25281;20030;6926;5488;7923;24728;117;123;2013;2113;HOSPITAL DE REHABILITACION M. ROCCA;
Medicina;Subtotal Medicina;83;2;85;76;1;77;4;81;25281;20030;6926;5488;7923;24728;117;123;2013;2113;HOSPITAL DE REHABILITACION M. ROCCA;
Cirugia;Cirugía General;108;4;112;106;0;106;2;108;2115;1048;579;287;4955;97;1864;0;2013;2113;HOSPITAL DE REHABILITACION M. ROCCA;
Cirugia;Subtotal Cirugia;108;4;112;106;0;106;2;108;2115;1048;579;287;4955;97;1864;0;2013;2113;HOSPITAL DE REHABILITACION M. ROCCA;
Cirugia;Total Hospital;191;6;197;182;1;183;6;189;27396;21078;7506;5775;7694;11518;244;55;2013;2113;HOSPITAL DE REHABILITACION M. ROCCA;
Medicina;Fisiatría;65;4;69;68;1;69;2;71;10920;4461;2992;1222;4085;6283;237;141;2013;2114;INSTITUTO DE REHABILITACION PSICOFISICA (I.R.E.P.);
Medicina;Subtotal Medicina;65;4;69;68;1;69;2;71;10920;4461;2992;1222;4085;6283;237;141;2013;2114;INSTITUTO DE REHABILITACION PSICOFISICA (I.R.E.P.);
Medicina;Unidad Coronaria;339;169;508;179;32;211;295;506;2555;2065;7;566;8082;408;7229;632;2013;2162;HOSPITAL GENERAL DE AGUDOS J. M. RAMOS MEJIA;
Medicina;Subtotal Medicina;1791;1776;3567;2693;182;2875;705;3580;60321;47755;16526;13084;7917;1334;2166;508;2013;2162;HOSPITAL GENERAL DE AGUDOS J. M. RAMOS MEJIA;
Cirugia;Cirugía General;730;938;1668;1445;18;1463;199;1662;22045;15404;604;422;6988;927;2752;108;2013;2162;HOSPITAL GENERAL DE AGUDOS J. M. RAMOS MEJIA;
Cirugia;Cirugía Plástica Y Reparadora - niÃ±os;424;18;442;414;0;414;29;443;4313;1237;1182;339;2868;279;3749;0;2013;2162;HOSPITAL GENERAL DE AGUDOS J. M. RAMOS MEJIA;
Cirugia;Ginecología;387;22;409;395;6;401;13;414;5921;4083;1622;1119;6896;986;2552;145;2013;2162;HOSPITAL GENERAL DE AGUDOS J. M. RAMOS MEJIA;
Cirugia;Oftalmología;112;1;113;111;0;111;2;113;769;117;211;32;1521;104;5363;0;2013;2162;HOSPITAL GENERAL DE AGUDOS J. M. RAMOS MEJIA;
Cirugia;Ortopedia Y Traumatología;294;77;371;348;4;352;32;384;11372;8574;3116;2349;754;2233;1233;104;2013;2162;HOSPITAL GENERAL DE AGUDOS J. M. RAMOS MEJIA;
Cirugia;Otorrinolaringología;290;65;355;276;0;276;79;355;2277;1191;624;326;5231;335;5691;0;2013;2162;HOSPITAL GENERAL DE AGUDOS J. M. RAMOS MEJIA;
Cirugia;Urología;236;69;305;287;1;288;25;313;7573;5270;2075;1444;6959;1684;1509;32;2013;2162;HOSPITAL GENERAL DE AGUDOS J. M. RAMOS MEJIA;
Cirugia;Subtotal Cirugia;2473;1190;3663;3276;29;3305;379;3684;54270;35876;14868;9829;6611;974;2478;79;2013;2162;HOSPITAL GENERAL DE AGUDOS J. M. RAMOS MEJIA;
Pediatria;Recien Nacido Sano;1424;0;1424;1367;0;1367;60;1427;5865;4116;1607;1128;7018;288;8881;0;2013;2162;HOSPITAL GENERAL DE AGUDOS J. M. RAMOS MEJIA;
Pediatria;Neonatología;192;61;253;241;11;252;0;252;4463;3441;1223;943;771;1365;2061;437;2013;2162;HOSPITAL GENERAL DE AGUDOS J. M. RAMOS MEJIA;
Pediatria;Pediatría;432;6;438;435;1;436;1;437;6303;2425;1727;664;3847;555;2531;23;2013;2162;HOSPITAL GENERAL DE AGUDOS J. M. RAMOS MEJIA;
Pediatria;Subtotal Pediatria;2048;67;2115;2043;12;2055;61;2116;16631;9982;4556;2735;6002;472;4644;57;2013;2162;HOSPITAL GENERAL DE AGUDOS J. M. RAMOS MEJIA;
Tocoginecologia;Obstetricia;2178;11;2189;2174;0;2174;18;2192;9230;8047;2529;2205;8718;367;8668;0;2013;2162;HOSPITAL GENERAL DE AGUDOS J. M. RAMOS MEJIA;
Tocoginecologia;Subtotal Tocoginecologia;2178;11;2189;2174;0;2174;18;2192;9230;8047;2529;2205;8718;367;8668;0;2013;2162;HOSPITAL GENERAL DE AGUDOS J. M. RAMOS MEJIA;
Urgencia;Guardia Del Día;3020;146;3166;748;322;1070;2084;3154;4818;5817;132;1594;12073;184;23894;1021;2013;2162;HOSPITAL GENERAL DE AGUDOS J. M. RAMOS MEJIA;
Urgencia;Terapia Intensiva;16;321;337;6;66;72;264;336;3712;3181;1017;872;857;947;3304;1964;2013;2162;HOSPITAL GENERAL DE AGUDOS J. M. RAMOS MEJIA;
Urgencia;Subtotal Urgencia;3036;467;3503;754;388;1142;2348;3490;8530;8998;2337;2465;10549;258;14934;1112;2013;2162;HOSPITAL GENERAL DE AGUDOS J. M. RAMOS MEJIA;
Urgencia;Total Hospital;11526;3511;15037;10940;611;11551;3511;15062;148982;110658;40817;30317;7428;958;283;529;2013;2162;HOSPITAL GENERAL DE AGUDOS J. M. RAMOS MEJIA;
Medicina;Cardiología;46;172;218;185;1;186;29;215;4266;1208;1169;331;2832;562;184;47;2013;2119;HOSPITAL GENERAL DE AGUDOS B. RIVADAVIA;
Medicina;Clínica Médica;611;143;754;598;58;656;110;766;14961;10312;4099;2825;6893;1346;1869;757;2013;2119;HOSPITAL GENERAL DE AGUDOS B. RIVADAVIA;
Medicina;Nutrición;85;8;93;91;0;91;2;93;3789;1299;1038;356;3428;1397;896;0;2013;2119;HOSPITAL GENERAL DE AGUDOS B. RIVADAVIA;
Medicina;Curieterapia;75;2;77;74;0;74;3;77;987;232;27;64;2351;301;2848;0;2013;2119;HOSPITAL GENERAL DE AGUDOS B. RIVADAVIA;
Medicina;Unidad Coronaria;193;84;277;55;6;61;216;277;2118;1248;58;342;5892;451;4774;217;2013;2119;HOSPITAL GENERAL DE AGUDOS B. RIVADAVIA;
Medicina;Subtotal Medicina;1010;409;1419;1003;65;1068;360;1428;26121;14299;7156;3918;5474;1001;1995;455;2013;2119;HOSPITAL GENERAL DE AGUDOS B. RIVADAVIA;
Cirugia;Cirugía General;733;75;808;717;10;727;84;811;12160;3913;3332;1072;3218;482;2434;123;2013;2119;HOSPITAL GENERAL DE AGUDOS B. RIVADAVIA;
Cirugia;Cirugía Cardiovascular;51;18;69;57;0;57;12;69;1714;302;47;83;1762;438;1469;0;2013;2119;HOSPITAL GENERAL DE AGUDOS B. RIVADAVIA;
Cirugia;Ginecología;426;10;436;423;1;424;11;435;5536;1465;1517;401;2646;337;2868;23;2013;2119;HOSPITAL GENERAL DE AGUDOS B. RIVADAVIA;
Cirugia;Neurocirugía;118;33;151;120;1;121;30;151;1786;726;489;199;4065;481;3086;66;2013;2119;HOSPITAL GENERAL DE AGUDOS B. RIVADAVIA;
Cirugia;Ortopedia Y Traumatología;260;11;271;253;1;254;14;268;4180;2650;1145;726;634;989;234;37;2013;2119;HOSPITAL GENERAL DE AGUDOS B. RIVADAVIA;
Cirugia;Otorrinolaringología;135;10;145;139;0;139;6;145;1574;299;431;82;19;206;3362;0;2013;2119;HOSPITAL GENERAL DE AGUDOS B. RIVADAVIA;
Cirugia;Urología;252;11;263;248;1;249;13;262;4056;1351;1111;37;3331;516;2358;38;2013;2119;HOSPITAL GENERAL DE AGUDOS B. RIVADAVIA;
Cirugia;Subtotal Cirugia;1975;168;2143;1957;14;1971;170;2141;31006;10706;8495;2933;3453;5;252;65;2013;2119;HOSPITAL GENERAL DE AGUDOS B. RIVADAVIA;
Pediatria;Recien Nacido Sano;836;198;1034;982;0;982;54;1036;3965;3696;1086;1013;9322;357;9537;0;2013;2119;HOSPITAL GENERAL DE AGUDOS B. RIVADAVIA;
Pediatria;Neonatología;323;54;377;167;12;179;203;382;6998;4169;1917;1142;5957;1091;1992;314;2013;2119;HOSPITAL GENERAL DE AGUDOS B. RIVADAVIA;
Pediatria;Pediatría;522;5;527;530;0;530;0;530;5606;2008;1536;55;3582;379;3451;0;2013;2119;HOSPITAL GENERAL DE AGUDOS B. RIVADAVIA;
Pediatria;Subtotal Pediatria;1681;257;1938;1679;12;1691;257;1948;16569;9873;4539;2705;5959;507;4291;62;2013;2119;HOSPITAL GENERAL DE AGUDOS B. RIVADAVIA;
Tocoginecologia;Obstetricia;1467;5;1472;1467;0;1467;7;1474;10267;8534;2813;2338;8312;579;524;0;2013;2119;HOSPITAL GENERAL DE AGUDOS B. RIVADAVIA;
Tocoginecologia;Subtotal Tocoginecologia;1467;5;1472;1467;0;1467;7;1474;10267;8534;2813;2338;8312;579;524;0;2013;2119;HOSPITAL GENERAL DE AGUDOS B. RIVADAVIA;
Urgencia;Coordinacion Cuidados Intensivos;129;153;282;14;68;82;198;280;3014;2237;826;613;7422;799;3391;2429;2013;2119;HOSPITAL GENERAL DE AGUDOS B. RIVADAVIA;
Urgencia;Subtotal Urgencia;129;153;282;14;68;82;198;280;3014;2237;826;613;7422;799;3391;2429;2013;2119;HOSPITAL GENERAL DE AGUDOS B. RIVADAVIA;
Urgencia;Total Hospital;6262;992;7254;6120;159;6279;992;7271;86977;45649;23829;12507;5248;727;2635;253;2013;2119;HOSPITAL GENERAL DE AGUDOS B. RIVADAVIA;
Medicina;Cardiología;208;226;434;351;3;354;81;435;2920;1997;8;547;6839;459;5438;69;2013;2121;HOSPITAL GENERAL DE AGUDOS DONACION F. SANTOJANNI;
Medicina;Clínica Médica;1007;233;1240;897;169;1066;168;1234;22768;19906;6238;5454;8743;1613;1978;137;2013;2121;HOSPITAL GENERAL DE AGUDOS DONACION F. SANTOJANNI;
Medicina;Unidad Coronaria;409;202;611;226;43;269;340;609;2920;1836;8;503;6288;301;7613;706;2013;2121;HOSPITAL GENERAL DE AGUDOS DONACION F. SANTOJANNI;
Medicina;Subtotal Medicina;1624;661;2285;1474;215;1689;589;2278;28608;23739;7838;6504;8298;1042;2906;944;2013;2121;HOSPITAL GENERAL DE AGUDOS DONACION F. SANTOJANNI;
Cirugia;Cirugía General;1167;194;1361;1282;17;1299;61;1360;11280;8363;309;2291;7414;615;4401;125;2013;2121;HOSPITAL GENERAL DE AGUDOS DONACION F. SANTOJANNI;
Cirugia;Microcirugia Y Cirugia Reparadora;398;8;406;400;0;400;7;407;2074;1161;568;318;5598;285;7163;0;2013;2121;HOSPITAL GENERAL DE AGUDOS DONACION F. SANTOJANNI;
Cirugia;Ginecología;577;64;641;597;1;598;39;637;5107;3192;1399;875;625;501;4553;16;2013;2121;HOSPITAL GENERAL DE AGUDOS DONACION F. SANTOJANNI;
Cirugia;Neurocirugía;188;64;252;187;5;192;43;235;5023;4556;1376;1248;907;1939;1708;213;2013;2121;HOSPITAL GENERAL DE AGUDOS DONACION F. SANTOJANNI;
Cirugia;Ortopedia Y Traumatología;480;42;522;484;10;494;26;520;9115;7159;2497;1961;7854;1377;2082;192;2013;2121;HOSPITAL GENERAL DE AGUDOS DONACION F. SANTOJANNI;
Cirugia;Otorrinolaringología;20;1;21;21;0;21;0;21;1709;20;468;5;117;95;449;0;2013;2121;HOSPITAL GENERAL DE AGUDOS DONACION F. SANTOJANNI;
Cirugia;Urología;226;23;249;233;1;234;15;249;1951;1407;535;385;7212;565;4658;4;2013;2121;HOSPITAL GENERAL DE AGUDOS DONACION F. SANTOJANNI;
Cirugia;Subtotal Cirugia;3056;396;3452;3204;34;3238;191;3429;36259;25858;9934;7084;7131;754;3452;99;2013;2121;HOSPITAL GENERAL DE AGUDOS DONACION F. SANTOJANNI;
Pediatria;Recien Nacido Sano;3589;211;3800;3776;1;3777;23;3800;21786;15025;5969;4116;6897;395;6366;3;2013;2121;HOSPITAL GENERAL DE AGUDOS DONACION F. SANTOJANNI;
Pediatria;Neonatología;442;196;638;220;33;253;391;644;10262;5980;2812;1638;5827;929;2291;512;2013;2121;HOSPITAL GENERAL DE AGUDOS DONACION F. SANTOJANNI;
Pediatria;Pediatría;1133;2;1135;1136;0;1136;0;1136;9493;5088;2601;1394;536;448;4368;0;2013;2121;HOSPITAL GENERAL DE AGUDOS DONACION F. SANTOJANNI;
Pediatria;Subtotal Pediatria;5164;409;5573;5132;34;5166;414;5580;41541;26093;11381;7149;6281;468;4903;61;2013;2121;HOSPITAL GENERAL DE AGUDOS DONACION F. SANTOJANNI;
Tocoginecologia;Obstetricia;4499;7;4506;4502;0;4502;3;4505;23270;20836;6375;5708;8954;463;7066;0;2013;2121;HOSPITAL GENERAL DE AGUDOS DONACION F. SANTOJANNI;
Tocoginecologia;Subtotal Tocoginecologia;4499;7;4506;4502;0;4502;3;4505;23270;20836;6375;5708;8954;463;7066;0;2013;2121;HOSPITAL GENERAL DE AGUDOS DONACION F. SANTOJANNI;
Urgencia;Terapia Intermedia;24;96;120;8;8;16;106;122;2920;605;8;166;2072;496;1525;656;2013;2121;HOSPITAL GENERAL DE AGUDOS DONACION F. SANTOJANNI;
Urgencia;Terapia Intensiva;140;186;326;7;90;97;227;324;4380;3407;12;933;7779;1052;27;2778;2013;2121;HOSPITAL GENERAL DE AGUDOS DONACION F. SANTOJANNI;
Urgencia;Observación ;459;200;659;48;181;229;425;654;2925;1992;801;546;681;305;8161;2768;2013;2121;HOSPITAL GENERAL DE AGUDOS DONACION F. SANTOJANNI;
Urgencia;Subtotal Urgencia;623;482;1105;63;279;342;758;1100;10225;6004;2801;1645;5872;546;3927;2536;2013;2121;HOSPITAL GENERAL DE AGUDOS DONACION F. SANTOJANNI;
Urgencia;Total Hospital;14966;1955;16921;14375;562;14937;1955;16892;139903;102530;3833;2809;7329;686;3897;376;2013;2121;HOSPITAL GENERAL DE AGUDOS DONACION F. SANTOJANNI;
Medicina;Cuidados Paliativos;152;35;187;118;69;187;0;187;1341;1259;367;345;9389;673;509;369;2013;2124;HOSPITAL GENERAL DE AGUDOS DR. E. TORNU;
Medicina;Clínica Médica;529;1026;1555;1249;102;1351;198;1549;18270;15953;5005;4371;8732;103;3095;658;2013;2124;HOSPITAL GENERAL DE AGUDOS DR. E. TORNU;
Medicina;Neumotisiología;169;300;469;357;15;372;88;460;13174;4717;3609;1292;3581;1025;1274;326;2013;2124;HOSPITAL GENERAL DE AGUDOS DR. E. TORNU;
Medicina;Subtotal Medicina;850;1361;2211;1724;186;1910;286;2196;32785;21929;8982;6008;6689;999;2445;847;2013;2124;HOSPITAL GENERAL DE AGUDOS DR. E. TORNU;
Cirugia;Cirugía General;536;348;884;817;2;819;71;890;8466;5020;2319;1375;593;564;3837;22;2013;2124;HOSPITAL GENERAL DE AGUDOS DR. E. TORNU;
Cirugia;Cirugía Toracica;61;58;119;81;0;81;39;120;2151;648;589;178;3013;54;2036;0;2013;2124;HOSPITAL GENERAL DE AGUDOS DR. E. TORNU;
Cirugia;Ginecología;161;6;167;162;0;162;4;166;461;461;126;126;100;278;13143;0;2013;2124;HOSPITAL GENERAL DE AGUDOS DR. E. TORNU;
Cirugia;Ortopedia Y Traumatología;69;124;193;166;3;169;31;200;4339;2178;1189;597;502;1089;1682;15;2013;2124;HOSPITAL GENERAL DE AGUDOS DR. E. TORNU;
Cirugia;Urología;194;28;222;204;0;204;16;220;890;887;244;243;9966;403;9022;0;2013;2124;HOSPITAL GENERAL DE AGUDOS DR. E. TORNU;
Cirugia;Subtotal Cirugia;1021;564;1585;1430;5;1435;161;1596;16307;9194;4468;2519;5638;576;3572;31;2013;2124;HOSPITAL GENERAL DE AGUDOS DR. E. TORNU;
Urgencia;Terapia Intermedia;23;192;215;103;24;127;90;217;3642;2731;998;748;7499;1259;2175;1106;2013;2124;HOSPITAL GENERAL DE AGUDOS DR. E. TORNU;
Urgencia;Guardia Del Día;3262;57;3319;1497;87;1584;1733;3317;2204;2200;604;603;9982;66;54932;262;2013;2124;HOSPITAL GENERAL DE AGUDOS DR. E. TORNU;
Urgencia;Terapia Intensiva;6;249;255;34;64;98;153;251;3548;2634;972;722;7424;1049;2582;255;2013;2124;HOSPITAL GENERAL DE AGUDOS DR. E. TORNU;
Urgencia;Subtotal Urgencia;3291;498;3789;1634;175;1809;1976;3785;9394;7565;2574;2073;8053;2;14706;462;2013;2124;HOSPITAL GENERAL DE AGUDOS DR. E. TORNU;
Urgencia;Total Hospital;5162;2423;7585;4788;366;5154;2423;7577;58486;38688;16024;10599;6615;751;3217;71;2013;2124;HOSPITAL GENERAL DE AGUDOS DR. E. TORNU;
Medicina;Cardiología;27;26;53;44;0;44;3;47;1001;747;274;205;7463;1589;1714;0;2013;2120;HOSPITAL GENERAL DE AGUDOS D. VELEZ SARSFIELD;
Medicina;Clínica Médica;240;34;274;229;33;262;22;284;4505;3822;1234;1047;8484;1346;2301;1162;2013;2120;HOSPITAL GENERAL DE AGUDOS D. VELEZ SARSFIELD;
Medicina;Subtotal Medicina;267;60;327;273;33;306;25;331;5506;4569;1508;1252;8298;138;2194;997;2013;2120;HOSPITAL GENERAL DE AGUDOS D. VELEZ SARSFIELD;
Cirugia;Cirugía General;552;39;591;556;4;560;31;591;4614;3763;1264;1031;8156;637;4675;68;2013;2120;HOSPITAL GENERAL DE AGUDOS D. VELEZ SARSFIELD;
Cirugia;Ginecología;117;6;123;120;0;120;2;122;945;767;259;21;8116;629;4712;0;2013;2120;HOSPITAL GENERAL DE AGUDOS D. VELEZ SARSFIELD;
Cirugia;Oftalmología;2;0;2;2;0;2;0;2;565;40;155;11;708;20;129;0;2013;2120;HOSPITAL GENERAL DE AGUDOS D. VELEZ SARSFIELD;
Cirugia;Ortopedia Y Traumatología;209;15;224;202;4;206;11;217;3959;3737;1085;1024;9439;1722;2001;184;2013;2120;HOSPITAL GENERAL DE AGUDOS D. VELEZ SARSFIELD;
Cirugia;Subtotal Cirugia;880;60;940;880;8;888;44;932;10083;8307;2762;2276;8239;891;3374;86;2013;2120;HOSPITAL GENERAL DE AGUDOS D. VELEZ SARSFIELD;
Pediatria;Recien Nacido Sano;654;267;921;805;0;805;117;922;6412;2869;1757;786;4474;311;5248;0;2013;2120;HOSPITAL GENERAL DE AGUDOS D. VELEZ SARSFIELD;
Pediatria;Neonatología;537;117;654;382;1;383;272;655;3052;2452;836;672;8034;374;7833;15;2013;2120;HOSPITAL GENERAL DE AGUDOS D. VELEZ SARSFIELD;
Pediatria;Pediatría;553;16;569;575;0;575;1;576;4798;2428;1315;665;506;422;4382;0;2013;2120;HOSPITAL GENERAL DE AGUDOS D. VELEZ SARSFIELD;
Pediatria;Subtotal Pediatria;1744;400;2144;1762;1;1763;390;2153;14262;7749;3907;2123;5433;36;551;5;2013;2120;HOSPITAL GENERAL DE AGUDOS D. VELEZ SARSFIELD;
Tocoginecologia;Obstetricia;1314;8;1322;1308;0;1308;11;1319;8031;4812;22;1318;5992;365;5995;0;2013;2120;HOSPITAL GENERAL DE AGUDOS D. VELEZ SARSFIELD;
Tocoginecologia;Subtotal Tocoginecologia;1314;8;1322;1308;0;1308;11;1319;8031;4812;22;1318;5992;365;5995;0;2013;2120;HOSPITAL GENERAL DE AGUDOS D. VELEZ SARSFIELD;
Urgencia;Terapia Intensiva;101;57;158;12;30;42;115;157;2170;1971;595;54;9083;1255;2641;1911;2013;2120;HOSPITAL GENERAL DE AGUDOS D. VELEZ SARSFIELD;
Urgencia;Subtotal Urgencia;101;57;158;12;30;42;115;157;2170;1971;595;54;9083;1255;2641;1911;2013;2120;HOSPITAL GENERAL DE AGUDOS D. VELEZ SARSFIELD;
Urgencia;Total Hospital;4306;585;4891;4235;72;4307;585;4892;40052;27408;10973;7509;6843;636;3925;167;2013;2120;HOSPITAL GENERAL DE AGUDOS D. VELEZ SARSFIELD;
Medicina;Unidad Coronaria;159;36;195;111;14;125;73;198;1825;1507;5;413;8258;761;396;707;2013;2118;HOSPITAL GENERAL DE AGUDOS A. ZUBIZARRETA;
Medicina;Subtotal Medicina;159;36;195;111;14;125;73;198;1825;1507;5;413;8258;761;396;707;2013;2118;HOSPITAL GENERAL DE AGUDOS A. ZUBIZARRETA;
Pediatria;Adolescencia;35;0;35;40;0;40;0;40;1147;273;314;75;238;683;1273;0;2013;2118;HOSPITAL GENERAL DE AGUDOS A. ZUBIZARRETA;
Pediatria;Pediatría;529;0;529;540;0;540;0;540;5423;4316;1486;1182;7959;799;3635;0;2013;2118;HOSPITAL GENERAL DE AGUDOS A. ZUBIZARRETA;
Pediatria;Subtotal Pediatria;564;0;564;580;0;580;0;580;6570;4589;18;1257;6985;791;3222;0;2013;2118;HOSPITAL GENERAL DE AGUDOS A. ZUBIZARRETA;
Urgencia;Terapia Intermedia;972;359;1331;1189;19;1208;123;1331;10590;6864;2901;1881;6482;516;4587;143;2013;2118;HOSPITAL GENERAL DE AGUDOS A. ZUBIZARRETA;
Urgencia;Terapia Intensiva;73;101;174;7;43;50;125;175;2190;1829;6;501;8352;1045;2917;2457;2013;2118;HOSPITAL GENERAL DE AGUDOS A. ZUBIZARRETA;
Urgencia;Subtotal Urgencia;1045;460;1505;1196;62;1258;248;1506;12780;8693;3501;2382;6802;577;4301;412;2013;2118;HOSPITAL GENERAL DE AGUDOS A. ZUBIZARRETA;
Area Indiferenciada;Area Indiferenciada - Cuidados Alejados;1369;67;1436;1040;145;1185;242;1427;16369;12261;4485;3359;749;859;3182;1016;2013;2118;HOSPITAL GENERAL DE AGUDOS A. ZUBIZARRETA;
Area Indiferenciada;Subtotal Area Indiferenciada;1369;67;1436;1040;145;1185;242;1427;16369;12261;4485;3359;749;859;3182;1016;2013;2118;HOSPITAL GENERAL DE AGUDOS A. ZUBIZARRETA;
Area Indiferenciada;Total Hospital;3137;563;3700;2927;221;3148;563;3711;37544;27050;10286;7411;7205;859;306;702;2013;2118;HOSPITAL GENERAL DE AGUDOS A. ZUBIZARRETA;
Cuidados Genereales - Area Indiferenciada;Sector 1;845;264;1109;1055;1;1056;48;1104;8730;6894;2392;1889;7897;624;4616;9;2013;2172;HOSPITAL GENERAL DE NIÑOS PEDRO DE ELIZALDE;
Cuidados Genereales - Area Indiferenciada;Sector 2;699;199;898;839;3;842;47;889;8279;6339;2268;1737;7657;713;3919;34;2013;2172;HOSPITAL GENERAL DE NIÑOS PEDRO DE ELIZALDE;
Cuidados Genereales - Area Indiferenciada;Sector 3 A;273;119;392;349;1;350;39;389;3715;2992;1018;738;7246;692;3822;26;2013;2172;HOSPITAL GENERAL DE NIÑOS PEDRO DE ELIZALDE;
Cuidados Genereales - Area Indiferenciada;Sector 3 B - Presión Negativa;240;119;359;303;1;304;55;359;4874;3186;1335;873;6537;887;2688;28;2013;2172;HOSPITAL GENERAL DE NIÑOS PEDRO DE ELIZALDE;
Cuidados Genereales - Area Indiferenciada;Sector 4;849;251;1100;1029;0;1029;63;1092;8742;6743;2395;1847;7713;617;4559;0;2013;2172;HOSPITAL GENERAL DE NIÑOS PEDRO DE ELIZALDE;
Cuidados Genereales - Area Indiferenciada;Sector 5;748;181;929;886;0;886;43;929;8679;6138;2378;1682;7072;661;3907;0;2013;2172;HOSPITAL GENERAL DE NIÑOS PEDRO DE ELIZALDE;
Cuidados Genereales - Area Indiferenciada;Sector 6 A;516;91;607;541;5;546;62;608;4582;2748;1255;753;5997;452;4843;82;2013;2172;HOSPITAL GENERAL DE NIÑOS PEDRO DE ELIZALDE;
Cuidados Genereales - Area Indiferenciada;Sector 6 B - Presión Positiva;194;44;238;198;3;201;39;240;3376;1784;925;489;5284;743;2595;125;2013;2172;HOSPITAL GENERAL DE NIÑOS PEDRO DE ELIZALDE;
Cuidados Genereales - Area Indiferenciada;Sector 7;2088;164;2252;2133;2;2135;123;2258;10001;6796;274;1862;6795;301;8241;9;2013;2172;HOSPITAL GENERAL DE NIÑOS PEDRO DE ELIZALDE;
Cuidados Genereales - Area Indiferenciada;Subtotal Cuidados Genereales - Area Indiferenciada;6452;1432;7884;7333;16;7349;519;7868;60978;43320;16706;11868;7104;551;471;2;2013;2172;HOSPITAL GENERAL DE NIÑOS PEDRO DE ELIZALDE;
Cuidados Especiales;Neonatología Alta Complejidad;143;26;169;32;33;65;109;174;4374;2465;1198;675;5636;1417;1452;1897;2013;2172;HOSPITAL GENERAL DE NIÑOS PEDRO DE ELIZALDE;
Cuidados Especiales;Neonatología Mediana Complejidad;150;103;253;228;0;228;29;257;4365;2800;1196;767;6415;1089;2149;0;2013;2172;HOSPITAL GENERAL DE NIÑOS PEDRO DE ELIZALDE;
Cuidados Especiales;Cuidados Intermedios;95;185;280;77;3;80;200;280;2929;2149;802;589;7337;768;3489;107;2013;2172;HOSPITAL GENERAL DE NIÑOS PEDRO DE ELIZALDE;
Cuidados Especiales;Cuidados Intensivos;151;206;357;17;29;46;308;354;3993;2327;1094;638;5828;657;3236;819;2013;2172;HOSPITAL GENERAL DE NIÑOS PEDRO DE ELIZALDE;
Cuidados Especiales;Cirugía Cardiovascular;118;43;161;114;19;133;27;160;3270;1612;896;442;493;1008;1786;1188;2013;2172;HOSPITAL GENERAL DE NIÑOS PEDRO DE ELIZALDE;
Cuidados Especiales;Guardia;2000;0;2000;1198;1;1199;803;2002;2931;2200;803;603;7506;11;24931;5;2013;2172;HOSPITAL GENERAL DE NIÑOS PEDRO DE ELIZALDE;
Cuidados Especiales;Subtotal Cuidados Especiales;2657;563;3220;1666;85;1751;1476;3227;21862;13553;599;3713;6199;42;5388;263;2013;2172;HOSPITAL GENERAL DE NIÑOS PEDRO DE ELIZALDE;
Cuidados Especiales;Total Hospital;9109;1995;11104;8999;101;9100;1995;11095;82840;56873;22696;15582;6865;625;401;111;2013;2172;HOSPITAL GENERAL DE NIÑOS PEDRO DE ELIZALDE;
Medicina;Pediatria;3085;589;3674;3167;5;3172;491;3663;35529;30338;9734;8312;8539;828;3763;14;2013;2164;HOSPITAL GENERAL DE NIÑOS RICARDO GUTIERREZ;
Medicina;Endocrinología;315;0;315;315;0;315;0;315;2196;310;602;85;1412;98;5236;0;2013;2164;HOSPITAL GENERAL DE NIÑOS RICARDO GUTIERREZ;
Medicina;Infecciosas;509;180;689;536;12;548;138;686;8720;7791;2389;2135;8935;1136;2871;175;2013;2164;HOSPITAL GENERAL DE NIÑOS RICARDO GUTIERREZ;
Medicina;Neonatología;230;24;254;203;19;222;36;258;6659;4876;1824;1336;7322;189;1414;736;2013;2164;HOSPITAL GENERAL DE NIÑOS RICARDO GUTIERREZ;
Medicina;Centro Respiratorio;238;102;340;211;0;211;128;339;4374;3613;1198;99;826;1066;2829;0;2013;2164;HOSPITAL GENERAL DE NIÑOS RICARDO GUTIERREZ;
Medicina;Nefrología;307;24;331;302;0;302;28;330;4392;2405;1203;659;5476;729;2742;0;2013;2164;HOSPITAL GENERAL DE NIÑOS RICARDO GUTIERREZ;
Medicina;Subtotal Medicina;4684;919;5603;4734;36;4770;821;5591;61870;49333;16951;13516;7974;882;3298;64;2013;2164;HOSPITAL GENERAL DE NIÑOS RICARDO GUTIERREZ;
Cirugia;Cirugía General;1688;169;1857;1670;1;1671;183;1854;10014;5645;2744;1547;5637;304;6758;5;2013;2164;HOSPITAL GENERAL DE NIÑOS RICARDO GUTIERREZ;
Cirugia;Cirugía Cardiovascular;198;27;225;185;20;205;16;221;4511;3311;1236;907;734;1498;1788;905;2013;2164;HOSPITAL GENERAL DE NIÑOS RICARDO GUTIERREZ;
Cirugia;Cirugía Plástica Y Reparadora - niÃ±os;605;23;628;609;0;609;19;628;3318;1714;909;47;5166;273;6908;0;2013;2164;HOSPITAL GENERAL DE NIÑOS RICARDO GUTIERREZ;
Cirugia;Neurocirugía;363;85;448;356;2;358;92;450;6878;2560;1884;701;3722;569;2388;44;2013;2164;HOSPITAL GENERAL DE NIÑOS RICARDO GUTIERREZ;
Cirugia;Ortopedia Y Traumatología;1270;107;1377;1263;0;1263;122;1385;13542;7144;371;1957;5275;516;3733;0;2013;2164;HOSPITAL GENERAL DE NIÑOS RICARDO GUTIERREZ;
Cirugia;Urologia;320;9;329;330;0;330;3;333;4758;1716;1304;47;3607;515;2555;0;2013;2164;HOSPITAL GENERAL DE NIÑOS RICARDO GUTIERREZ;
Cirugia;Subtotal Cirugia;4444;420;4864;4413;23;4436;435;4871;43021;22090;11787;6052;5135;454;4133;47;2013;2164;HOSPITAL GENERAL DE NIÑOS RICARDO GUTIERREZ;
Urgencia;Terapia Intermedia;72;313;385;31;2;33;351;384;2304;1300;631;356;5642;339;6083;52;2013;2164;HOSPITAL GENERAL DE NIÑOS RICARDO GUTIERREZ;
Urgencia;Terapia Intensiva;104;267;371;15;44;59;312;371;5442;4693;1491;1286;8624;1265;2488;1186;2013;2164;HOSPITAL GENERAL DE NIÑOS RICARDO GUTIERREZ;
Urgencia;Subtotal Urgencia;176;580;756;46;46;92;663;755;7746;5993;2122;1642;7737;794;3558;609;2013;2164;HOSPITAL GENERAL DE NIÑOS RICARDO GUTIERREZ;
Urgencia;Total Hospital;9304;1919;11223;9193;105;9298;1919;11217;112637;77416;30859;2121;6873;833;3013;113;2013;2164;HOSPITAL GENERAL DE NIÑOS RICARDO GUTIERREZ;
Pediatria;Recien Nacido Sano;5110;658;5768;5050;0;5050;717;5767;25185;15834;69;4338;6287;275;8358;0;2013;2167;HOSPITAL MATERNO INFANTIL R. SARDA;
Pediatria;Neonatología;1512;1275;2787;1477;83;1560;1216;2776;29565;15415;81;4223;5214;555;3427;299;2013;2167;HOSPITAL MATERNO INFANTIL R. SARDA;
Pediatria;Subtotal Pediatria;6622;1933;8555;6527;83;6610;1933;8543;54750;31249;150;8561;5708;366;5695;97;2013;2167;HOSPITAL MATERNO INFANTIL R. SARDA;
Tocoginecologia;Tocoginecología;7643;234;7877;7676;0;7676;195;7871;37964;29448;10401;8068;7757;374;7567;0;2013;2167;HOSPITAL MATERNO INFANTIL R. SARDA;
Tocoginecologia;Subtotal Tocoginecologia;7643;234;7877;7676;0;7676;195;7871;37964;29448;10401;8068;7757;374;7567;0;2013;2167;HOSPITAL MATERNO INFANTIL R. SARDA;
Urgencia;Terapia Intermedia;27;44;71;48;0;48;24;72;1095;248;3;68;2265;344;24;0;2013;2167;HOSPITAL MATERNO INFANTIL R. SARDA;
Urgencia;Terapia Intensiva;70;24;94;8;0;8;83;91;1460;358;4;98;2452;393;2275;0;2013;2167;HOSPITAL MATERNO INFANTIL R. SARDA;
Urgencia;Subtotal Urgencia;97;68;165;56;0;56;107;163;2555;606;7;166;2372;372;2329;0;2013;2167;HOSPITAL MATERNO INFANTIL R. SARDA;
Urgencia;Total Hospital;14362;2235;16597;14259;83;14342;2235;16577;95269;61303;26101;16795;6435;427;5495;58;2013;2167;HOSPITAL MATERNO INFANTIL R. SARDA;
Medicina;Dermatología;396;14;410;368;1;369;29;398;11674;7777;3198;2131;6662;1954;1244;25;2013;2110;HOSPITAL DE INFECCIOSAS F. MUÑIZ;
Medicina;Infecciosas;1513;297;1810;1446;80;1526;284;1810;41129;28757;11268;7879;6992;1589;1606;442;2013;2110;HOSPITAL DE INFECCIOSAS F. MUÑIZ;
Medicina;Hepatopatía;252;34;286;217;6;223;66;289;4750;1539;1301;422;324;533;2221;208;2013;2110;HOSPITAL DE INFECCIOSAS F. MUÑIZ;
Medicina;Neumotisiología;279;75;354;301;5;306;39;345;14929;11322;409;3102;7584;3282;843;145;2013;2110;HOSPITAL DE INFECCIOSAS F. MUÑIZ;
Medicina;Asistencia Respiratoria Intermedia;235;322;557;102;90;192;364;556;5823;3657;1595;1002;628;658;3485;1619;2013;2110;HOSPITAL DE INFECCIOSAS F. MUÑIZ;
Medicina;Zoopatología Médica;311;70;381;322;6;328;51;379;5595;3394;1533;93;6066;896;2472;158;2013;2110;HOSPITAL DE INFECCIOSAS F. MUÑIZ;
Medicina;Subtotal Medicina;2986;812;3798;2756;188;2944;833;3777;83900;56446;22986;15465;6728;1494;1643;498;2013;2110;HOSPITAL DE INFECCIOSAS F. MUÑIZ;
Cirugia;Cirugía General;549;78;627;554;8;562;64;626;10612;3477;2907;953;3276;555;2153;128;2013;2110;HOSPITAL DE INFECCIOSAS F. MUÑIZ;
Cirugia;Subtotal Cirugia;549;78;627;554;8;562;64;626;10612;3477;2907;953;3276;555;2153;128;2013;2110;HOSPITAL DE INFECCIOSAS F. MUÑIZ;
Pediatria;Infecciosas Pediatría;455;8;463;456;0;456;4;460;12211;4936;3345;1352;4042;1073;1375;0;2013;2110;HOSPITAL DE INFECCIOSAS F. MUÑIZ;
Pediatria;Subtotal Pediatria;455;8;463;456;0;456;4;460;12211;4936;3345;1352;4042;1073;1375;0;2013;2110;HOSPITAL DE INFECCIOSAS F. MUÑIZ;
Urgencia;Terapia Intensiva;103;145;248;16;88;104;142;246;2267;1655;621;453;73;673;3961;3577;2013;2110;HOSPITAL DE INFECCIOSAS F. MUÑIZ;
Cirugia;Oftalmología;166;10;176;139;1;140;37;177;2329;916;6;38;2;51;39;33;2014;2125;HOSPITAL GENERAL DE AGUDOS DR. I. PIROVANO;
Cirugia;Ortopedia Y Traumatología;657;76;733;553;35;588;140;728;17297;12049;47;39;33;1;69;66;2014;2125;HOSPITAL GENERAL DE AGUDOS DR. I. PIROVANO;
Cirugia;Otorrinolaringología;213;11;224;179;1;180;46;226;2839;1513;7;78;4;15;53;29;2014;2125;HOSPITAL GENERAL DE AGUDOS DR. I. PIROVANO;
Cirugia;Urología;310;73;383;366;5;371;13;384;4293;2482;11;76;6;80;57;82;2014;2125;HOSPITAL GENERAL DE AGUDOS DR. I. PIROVANO;
Cirugia;Subtotal Cirugia;3620;465;4085;3425;114;3539;541;4080;57430;40296;157;34;110;40;70;17;2014;2125;HOSPITAL GENERAL DE AGUDOS DR. I. PIROVANO;
Pediatria;Recien Nacido Sano;1044;0;1044;931;0;931;116;1047;11217;2968;30;73;8;13;26;46;2014;2125;HOSPITAL GENERAL DE AGUDOS DR. I. PIROVANO;
Pediatria;Neonatología;216;118;334;328;5;333;1;334;3141;2416;8;61;6;62;76;92;2014;2125;HOSPITAL GENERAL DE AGUDOS DR. I. PIROVANO;
Pediatria;Pediatría;1027;1;1028;1029;1;1030;2;1032;10679;3560;29;26;9;75;33;34;2014;2125;HOSPITAL GENERAL DE AGUDOS DR. I. PIROVANO;
Pediatria;Subtotal Pediatria;2287;119;2406;2288;6;2294;119;2413;25037;8944;68;59;24;50;35;72;2014;2125;HOSPITAL GENERAL DE AGUDOS DR. I. PIROVANO;
Tocoginecologia;Obstetricia;1852;8;1860;1828;0;1828;48;1876;11194;6326;30;67;17;33;56;51;2014;2125;HOSPITAL GENERAL DE AGUDOS DR. I. PIROVANO;
Tocoginecologia;Subtotal Tocoginecologia;1852;8;1860;1828;0;1828;48;1876;11194;6326;30;67;17;33;56;51;2014;2125;HOSPITAL GENERAL DE AGUDOS DR. I. PIROVANO;
Urgencia;Terapia Intermedia;17;89;106;20;2;22;87;109;1460;1250;4;0;3;42;85;62;2014;2125;HOSPITAL GENERAL DE AGUDOS DR. I. PIROVANO;
Urgencia;Terapia Intensiva;98;170;268;1;65;66;202;268;2920;2810;8;0;7;70;96;23;2014;2125;HOSPITAL GENERAL DE AGUDOS DR. I. PIROVANO;
Urgencia;Subtotal Urgencia;115;259;374;21;67;88;289;377;4380;4060;12;0;11;12;92;69;2014;2125;HOSPITAL GENERAL DE AGUDOS DR. I. PIROVANO;
Urgencia;Total Hospital;9151;1192;10343;8773;403;9176;1192;10368;123148;81485;337;39;223;25;66;17;2014;2125;HOSPITAL GENERAL DE AGUDOS DR. I. PIROVANO;
Medicina;Cardiología;163;271;434;360;6;366;65;431;7312;2460;20;3;6;74;33;64;2014;2162;HOSPITAL GENERAL DE AGUDOS J. M. RAMOS MEJIA;
Medicina;Clínica Médica;604;1055;1659;1301;147;1448;214;1662;34573;30307;94;72;83;3;87;66;2014;2162;HOSPITAL GENERAL DE AGUDOS J. M. RAMOS MEJIA;
Medicina;Dermatología;100;10;110;98;0;98;11;109;3691;2532;10;11;6;94;68;60;2014;2162;HOSPITAL GENERAL DE AGUDOS J. M. RAMOS MEJIA;
Medicina;Hematología;70;30;100;77;12;89;12;101;3406;2534;9;33;6;94;74;40;2014;2162;HOSPITAL GENERAL DE AGUDOS J. M. RAMOS MEJIA;
Medicina;Neurología;386;110;496;452;5;457;39;496;5874;3750;16;9;10;27;63;84;2014;2162;HOSPITAL GENERAL DE AGUDOS J. M. RAMOS MEJIA;
Medicina;Tisiología;98;58;156;132;7;139;15;154;5049;3036;13;83;8;32;60;13;2014;2162;HOSPITAL GENERAL DE AGUDOS J. M. RAMOS MEJIA;
Medicina;Unidad Coronaria;357;133;490;167;35;202;287;489;2557;1840;7;1;5;4;71;96;2014;2162;HOSPITAL GENERAL DE AGUDOS J. M. RAMOS MEJIA;
Medicina;Subtotal Medicina;1778;1667;3445;2587;212;2799;643;3442;62462;46459;171;13;127;28;74;38;2014;2162;HOSPITAL GENERAL DE AGUDOS J. M. RAMOS MEJIA;
Cirugia;Cirugía General;891;632;1523;1330;17;1347;189;1536;22765;13977;62;37;38;29;61;40;2014;2162;HOSPITAL GENERAL DE AGUDOS J. M. RAMOS MEJIA;
Cirugia;Cirugía Plástica Y Reparadora - niÃ±os;373;16;389;365;0;365;24;389;4748;962;13;1;2;64;20;26;2014;2162;HOSPITAL GENERAL DE AGUDOS J. M. RAMOS MEJIA;
Cirugia;Ginecología;342;27;369;342;5;347;24;371;5715;2253;15;66;6;17;39;42;2014;2162;HOSPITAL GENERAL DE AGUDOS J. M. RAMOS MEJIA;
Cirugia;Oftalmología;69;0;69;69;0;69;0;69;376;65;1;3;0;18;17;29;2014;2162;HOSPITAL GENERAL DE AGUDOS J. M. RAMOS MEJIA;
Cirugia;Ortopedia Y Traumatología;273;82;355;317;6;323;33;356;10616;5659;29;8;15;50;53;31;2014;2162;HOSPITAL GENERAL DE AGUDOS J. M. RAMOS MEJIA;
Cirugia;Otorrinolaringología;120;3;123;123;0;123;0;123;716;209;1;96;0;57;29;19;2014;2162;HOSPITAL GENERAL DE AGUDOS J. M. RAMOS MEJIA;
Cirugia;Urología;169;109;278;249;3;252;26;278;7355;4206;20;15;11;52;57;19;2014;2162;HOSPITAL GENERAL DE AGUDOS J. M. RAMOS MEJIA;
Cirugia;Subtotal Cirugia;2237;869;3106;2795;31;2826;296;3122;52291;27331;143;26;74;88;52;27;2014;2162;HOSPITAL GENERAL DE AGUDOS J. M. RAMOS MEJIA;
Pediatria;Recien Nacido Sano;1478;0;1478;1421;0;1421;58;1479;6670;4155;18;27;11;38;62;29;2014;2162;HOSPITAL GENERAL DE AGUDOS J. M. RAMOS MEJIA;
Pediatria;Neonatología;171;59;230;234;2;236;0;236;4548;2644;12;46;7;24;58;14;2014;2162;HOSPITAL GENERAL DE AGUDOS J. M. RAMOS MEJIA;
Pediatria;Pediatría;599;3;602;603;0;603;1;604;7835;2731;21;47;7;48;34;86;2014;2162;HOSPITAL GENERAL DE AGUDOS J. M. RAMOS MEJIA;
Pediatria;Subtotal Pediatria;2248;62;2310;2258;2;2260;59;2319;19053;9530;52;20;26;11;50;2;2014;2162;HOSPITAL GENERAL DE AGUDOS J. M. RAMOS MEJIA;
Tocoginecologia;Obstetricia;2098;16;2114;2100;0;2100;17;2117;9081;7941;24;88;21;76;87;45;2014;2162;HOSPITAL GENERAL DE AGUDOS J. M. RAMOS MEJIA;
Tocoginecologia;Subtotal Tocoginecologia;2098;16;2114;2100;0;2100;17;2117;9081;7941;24;88;21;76;87;45;2014;2162;HOSPITAL GENERAL DE AGUDOS J. M. RAMOS MEJIA;
Urgencia;Guardia Del Día;2721;158;2879;752;311;1063;1828;2891;4439;5319;12;16;14;57;119;82;2014;2162;HOSPITAL GENERAL DE AGUDOS J. M. RAMOS MEJIA;
Urgencia;Terapia Intensiva;28;329;357;8;92;100;258;358;3652;3171;10;1;8;69;86;83;2014;2162;HOSPITAL GENERAL DE AGUDOS J. M. RAMOS MEJIA;
Urgencia;Subtotal Urgencia;2749;487;3236;760;403;1163;2086;3249;8091;8490;22;17;23;26;104;93;2014;2162;HOSPITAL GENERAL DE AGUDOS J. M. RAMOS MEJIA;
Urgencia;Total Hospital;11110;3101;14211;10500;648;11148;3101;14249;150978;99751;413;64;273;29;66;7;2014;2162;HOSPITAL GENERAL DE AGUDOS J. M. RAMOS MEJIA;
Medicina;Cardiología;48;197;245;210;1;211;36;247;4614;1469;12;64;4;2;31;84;2014;2119;HOSPITAL GENERAL DE AGUDOS B. RIVADAVIA;
Medicina;Clínica Médica;655;124;779;619;77;696;82;778;17687;10931;48;46;29;95;61;80;2014;2119;HOSPITAL GENERAL DE AGUDOS B. RIVADAVIA;
Medicina;Nutrición;87;6;93;87;1;88;5;93;3293;996;9;2;2;73;30;25;2014;2119;HOSPITAL GENERAL DE AGUDOS B. RIVADAVIA;
Medicina;Curieterapia;36;0;36;36;0;36;0;36;1515;97;4;15;0;27;6;40;2014;2119;HOSPITAL GENERAL DE AGUDOS B. RIVADAVIA;
Medicina;Unidad Coronaria;213;87;300;55;5;60;242;302;2154;1431;5;90;3;92;66;43;2014;2119;HOSPITAL GENERAL DE AGUDOS B. RIVADAVIA;
Medicina;Subtotal Medicina;1039;414;1453;1007;84;1091;365;1456;29263;14924;80;17;40;89;51;0;2014;2119;HOSPITAL GENERAL DE AGUDOS B. RIVADAVIA;
Cirugia;Cirugía General;889;46;935;857;10;867;64;931;13511;4386;37;2;12;2;32;46;2014;2119;HOSPITAL GENERAL DE AGUDOS B. RIVADAVIA;
Cirugia;Cirugía Cardiovascular;49;26;75;54;0;54;21;75;1778;368;4;87;1;1;20;70;2014;2119;HOSPITAL GENERAL DE AGUDOS B. RIVADAVIA;
Cirugia;Ginecología;456;7;463;454;4;458;7;465;5445;1878;14;92;5;15;34;49;2014;2119;HOSPITAL GENERAL DE AGUDOS B. RIVADAVIA;
Cirugia;Neurocirugía;127;35;162;134;0;134;28;162;1811;862;4;96;2;36;47;60;2014;2119;HOSPITAL GENERAL DE AGUDOS B. RIVADAVIA;
Cirugia;Ortopedia Y Traumatología;289;19;308;280;3;283;25;308;4863;3524;13;32;9;65;72;47;2014;2119;HOSPITAL GENERAL DE AGUDOS B. RIVADAVIA;
Cirugia;Otorrinolaringología;172;5;177;173;0;173;4;177;2388;379;6;54;1;4;15;87;2014;2119;HOSPITAL GENERAL DE AGUDOS B. RIVADAVIA;
Cirugia;Urología;254;14;268;251;1;252;17;269;4355;1297;11;93;3;55;29;78;2014;2119;HOSPITAL GENERAL DE AGUDOS B. RIVADAVIA;
Cirugia;Subtotal Cirugia;2236;152;2388;2203;18;2221;166;2387;34151;12694;93;56;34;78;37;17;2014;2119;HOSPITAL GENERAL DE AGUDOS B. RIVADAVIA;
Pediatria;Recien Nacido Sano;1046;211;1257;1177;0;1177;80;1257;4319;4319;11;83;11;83;100;0;2014;2119;HOSPITAL GENERAL DE AGUDOS B. RIVADAVIA;
Pediatria;Neonatología;339;83;422;176;16;192;223;415;7312;4438;20;3;12;16;60;69;2014;2119;HOSPITAL GENERAL DE AGUDOS B. RIVADAVIA;
Pediatria;Pediatría;703;12;715;711;1;712;4;716;5490;2361;15;4;6;47;43;1;2014;2119;HOSPITAL GENERAL DE AGUDOS B. RIVADAVIA;
Pediatria;Subtotal Pediatria;2088;306;2394;2064;17;2081;307;2388;17121;11118;46;91;30;46;64;94;2014;2119;HOSPITAL GENERAL DE AGUDOS B. RIVADAVIA;
Tocoginecologia;Obstetricia;1706;6;1712;1706;0;1706;3;1709;11747;10014;32;18;27;44;85;25;2014;2119;HOSPITAL GENERAL DE AGUDOS B. RIVADAVIA;
Tocoginecologia;Subtotal Tocoginecologia;1706;6;1712;1706;0;1706;3;1709;11747;10014;32;18;27;44;85;25;2014;2119;HOSPITAL GENERAL DE AGUDOS B. RIVADAVIA;
Urgencia;Coordinacion Cuidados Intensivos;119;143;262;5;80;85;180;265;3298;2516;9;4;6;89;76;29;2014;2119;HOSPITAL GENERAL DE AGUDOS B. RIVADAVIA;
Urgencia;Subtotal Urgencia;119;143;262;5;80;85;180;265;3298;2516;9;4;6;89;76;29;2014;2119;HOSPITAL GENERAL DE AGUDOS B. RIVADAVIA;
Urgencia;Total Hospital;7188;1021;8209;6985;199;7184;1021;8205;95580;51266;261;86;140;45;53;64;2014;2119;HOSPITAL GENERAL DE AGUDOS B. RIVADAVIA;
Medicina;Cardiología;192;224;416;351;5;356;62;418;4144;2139;11;35;5;86;51;62;2014;2121;HOSPITAL GENERAL DE AGUDOS DONACION F. SANTOJANNI;
Medicina;Clínica Médica;885;168;1053;786;143;929;134;1063;24474;19258;67;5;52;76;78;69;2014;2121;HOSPITAL GENERAL DE AGUDOS DONACION F. SANTOJANNI;
Medicina;Unidad Coronaria;422;180;602;192;69;261;345;606;2920;1911;8;0;5;24;65;45;2014;2121;HOSPITAL GENERAL DE AGUDOS DONACION F. SANTOJANNI;
Medicina;Subtotal Medicina;1499;572;2071;1329;217;1546;541;2087;31538;23308;86;41;63;86;73;90;2014;2121;HOSPITAL GENERAL DE AGUDOS DONACION F. SANTOJANNI;
Cirugia;Cirugía General;1118;116;1234;1151;12;1163;75;1238;12509;8436;34;27;23;11;67;44;2014;2121;HOSPITAL GENERAL DE AGUDOS DONACION F. SANTOJANNI;
Cirugia;Cirugía Cardiovascular;11;0;11;11;0;11;0;11;244;10;0;67;0;3;4;10;2014;2121;HOSPITAL GENERAL DE AGUDOS DONACION F. SANTOJANNI;
Medicina;Clínica Médica;363;68;431;334;47;381;43;424;5920;5618;16;22;15;39;94;90;2014;2120;HOSPITAL GENERAL DE AGUDOS D. VELEZ SARSFIELD;
Medicina;Subtotal Medicina;419;108;527;412;47;459;66;525;6865;6438;18;81;17;64;93;78;2014;2120;HOSPITAL GENERAL DE AGUDOS D. VELEZ SARSFIELD;
Cirugia;Cirugía General;326;39;365;333;7;340;32;372;4162;3561;11;40;9;76;85;56;2014;2120;HOSPITAL GENERAL DE AGUDOS D. VELEZ SARSFIELD;
Cirugia;Ginecología;7;4;11;14;0;14;3;17;596;392;1;63;1;7;65;77;2014;2120;HOSPITAL GENERAL DE AGUDOS D. VELEZ SARSFIELD;
Cirugia;Ortopedia Y Traumatología;135;17;152;126;5;131;24;155;3178;2858;8;71;7;83;89;93;2014;2120;HOSPITAL GENERAL DE AGUDOS D. VELEZ SARSFIELD;
Cirugia;Subtotal Cirugia;468;60;528;473;12;485;59;544;7936;6811;21;74;18;66;85;82;2014;2120;HOSPITAL GENERAL DE AGUDOS D. VELEZ SARSFIELD;
Pediatria;Recien Nacido Sano;189;54;243;207;0;207;30;237;5001;1137;13;70;3;12;22;74;2014;2120;HOSPITAL GENERAL DE AGUDOS D. VELEZ SARSFIELD;
Pediatria;Neonatología;136;30;166;106;0;106;57;163;2813;869;7;71;2;38;30;89;2014;2120;HOSPITAL GENERAL DE AGUDOS D. VELEZ SARSFIELD;
Pediatria;Pediatría;602;27;629;622;0;622;7;629;5015;2236;13;74;6;13;44;59;2014;2120;HOSPITAL GENERAL DE AGUDOS D. VELEZ SARSFIELD;
Pediatria;Subtotal Pediatria;927;111;1038;935;0;935;94;1029;12829;4242;35;15;11;62;33;7;2014;2120;HOSPITAL GENERAL DE AGUDOS D. VELEZ SARSFIELD;
Tocoginecologia;Obstetricia;419;1;420;405;0;405;10;415;3997;2251;10;95;6;17;56;32;2014;2120;HOSPITAL GENERAL DE AGUDOS D. VELEZ SARSFIELD;
Tocoginecologia;Subtotal Tocoginecologia;419;1;420;405;0;405;10;415;3997;2251;10;95;6;17;56;32;2014;2120;HOSPITAL GENERAL DE AGUDOS D. VELEZ SARSFIELD;
Urgencia;Terapia Intensiva;105;44;149;14;42;56;95;151;2312;2006;6;33;5;50;86;76;2014;2120;HOSPITAL GENERAL DE AGUDOS D. VELEZ SARSFIELD;
Urgencia;Subtotal Urgencia;105;44;149;14;42;56;95;151;2312;2006;6;33;5;50;86;76;2014;2120;HOSPITAL GENERAL DE AGUDOS D. VELEZ SARSFIELD;
Urgencia;Total Hospital;2338;324;2662;2239;101;2340;324;2664;33939;21748;92;98;59;58;64;8;2014;2120;HOSPITAL GENERAL DE AGUDOS D. VELEZ SARSFIELD;
Medicina;Unidad Coronaria;171;46;217;121;14;135;81;216;1825;1473;5;0;4;0;80;7;2014;2118;HOSPITAL GENERAL DE AGUDOS A. ZUBIZARRETA;
Medicina;Subtotal Medicina;171;46;217;121;14;135;81;216;1825;1473;5;0;4;0;80;7;2014;2118;HOSPITAL GENERAL DE AGUDOS A. ZUBIZARRETA;
Pediatria;Adolescencia;62;0;62;66;0;66;3;69;1394;605;3;8;1;7;43;4;2014;2118;HOSPITAL GENERAL DE AGUDOS A. ZUBIZARRETA;
Pediatria;Pediatría;339;0;339;353;0;353;0;353;5176;3543;14;2;9;7;68;5;2014;2118;HOSPITAL GENERAL DE AGUDOS A. ZUBIZARRETA;
Pediatria;Subtotal Pediatria;401;0;401;419;0;419;3;422;6570;4148;18;0;11;4;63;1;2014;2118;HOSPITAL GENERAL DE AGUDOS A. ZUBIZARRETA;
Urgencia;Terapia Intermedia;1134;472;1606;1456;25;1481;179;1660;10950;7175;30;0;19;7;65;5;2014;2118;HOSPITAL GENERAL DE AGUDOS A. ZUBIZARRETA;
Urgencia;Terapia Intensiva;89;111;200;9;42;51;152;203;2190;1627;6;0;4;5;74;3;2014;2118;HOSPITAL GENERAL DE AGUDOS A. ZUBIZARRETA;
Urgencia;Subtotal Urgencia;1223;583;1806;1465;67;1532;331;1863;13140;8802;36;0;24;1;67;0;2014;2118;HOSPITAL GENERAL DE AGUDOS A. ZUBIZARRETA;
Area Indiferenciada;Area Indiferenciada - Cuidados Aleja;1526;348;1874;1187;135;1322;562;1884;16579;12726;;;;;;;2014;2118;HOSPITAL GENERAL DE AGUDOS A. ZUBIZARRETA;
Area Indiferenciada;Subtotal Area Indiferenciada;1526;348;1874;1187;135;1322;562;1884;16579;12726;45;4;34;9;76;8;2014;2118;HOSPITAL GENERAL DE AGUDOS A. ZUBIZARRETA;
Area Indiferenciada;Total Hospital;3321;977;4298;3192;216;3408;977;4385;38114;27149;104;4;74;4;71;2;2014;2118;HOSPITAL GENERAL DE AGUDOS A. ZUBIZARRETA;
Medicina;Psicopatologia Y Salud Mental;28;8;36;31;0;31;0;31;3016;1166;8;26;3;19;38;66;2014;2172;HOSPITAL GENERAL DE NIÑOS PEDRO DE ELIZALDE;
Medicina;Subtotal Medicina;28;8;36;31;0;31;0;31;3016;1166;8;26;3;19;38;66;2014;2172;HOSPITAL GENERAL DE NIÑOS PEDRO DE ELIZALDE;
Cuidados Grales - Area Indiferenciada;Sector 1;764;260;1024;986;0;986;45;1031;8487;7153;23;25;19;60;84;28;2014;2172;HOSPITAL GENERAL DE NIÑOS PEDRO DE ELIZALDE;
Cuidados Grales - Area Indiferenciada;Sector 2;684;265;949;899;0;899;52;951;7898;6618;21;64;18;13;83;79;2014;2172;HOSPITAL GENERAL DE NIÑOS PEDRO DE ELIZALDE;
Cuidados Grales - Area Indiferenciada;Sector 3 A;250;116;366;329;0;329;40;369;3679;2784;10;8;7;63;75;67;2014;2172;HOSPITAL GENERAL DE NIÑOS PEDRO DE ELIZALDE;
Cuidados Grales - Area Indiferenciada;Sector 3 B - Presión Negativa;197;77;274;237;0;237;36;273;4324;3606;11;85;9;88;83;40;2014;2172;HOSPITAL GENERAL DE NIÑOS PEDRO DE ELIZALDE;
Cuidados Grales - Area Indiferenciada;Sector 4;725;309;1034;989;0;989;47;1036;8303;7060;22;75;19;34;85;3;2014;2172;HOSPITAL GENERAL DE NIÑOS PEDRO DE ELIZALDE;
Cirugia;Microcirugia Y Cirugia Reparadora;417;6;423;421;0;421;1;422;1841;667;5;4;1;83;36;23;2014;2121;HOSPITAL GENERAL DE AGUDOS DONACION F. SANTOJANNI;
Cirugia;Ginecología;495;14;509;493;2;495;17;512;5111;3129;14;0;8;57;61;22;2014;2121;HOSPITAL GENERAL DE AGUDOS DONACION F. SANTOJANNI;
Cirugia;Neurocirugía;140;68;208;178;10;188;38;226;5307;4927;14;54;13;50;92;84;2014;2121;HOSPITAL GENERAL DE AGUDOS DONACION F. SANTOJANNI;
Cirugia;Ortopedia Y Traumatología;484;19;503;481;13;494;13;507;9137;7811;25;3;21;40;85;49;2014;2121;HOSPITAL GENERAL DE AGUDOS DONACION F. SANTOJANNI;
Cirugia;Otorrinolaringología;18;0;18;18;0;18;0;18;1198;18;3;28;0;5;1;50;2014;2121;HOSPITAL GENERAL DE AGUDOS DONACION F. SANTOJANNI;
Cirugia;Urología;181;18;199;189;1;190;7;197;1863;979;5;10;2;68;52;55;2014;2121;HOSPITAL GENERAL DE AGUDOS DONACION F. SANTOJANNI;
Cirugia;Subtotal Cirugia;2864;241;3105;2942;38;2980;151;3131;37210;25977;101;95;71;17;69;81;2014;2121;HOSPITAL GENERAL DE AGUDOS DONACION F. SANTOJANNI;
Pediatria;Recien Nacido Sano;2085;148;2233;2191;0;2191;33;2224;15876;8897;43;50;24;38;56;4;2014;2121;HOSPITAL GENERAL DE AGUDOS DONACION F. SANTOJANNI;
Pediatria;Neonatología;296;153;449;150;20;170;270;440;6825;4347;18;70;11;91;63;69;2014;2121;HOSPITAL GENERAL DE AGUDOS DONACION F. SANTOJANNI;
Pediatria;Pediatría;1124;3;1127;1128;0;1128;2;1130;9785;5264;26;81;14;42;53;80;2014;2121;HOSPITAL GENERAL DE AGUDOS DONACION F. SANTOJANNI;
Pediatria;Subtotal Pediatria;3505;304;3809;3469;20;3489;305;3794;32486;18508;89;0;50;71;56;97;2014;2121;HOSPITAL GENERAL DE AGUDOS DONACION F. SANTOJANNI;
Tocoginecologia;Obstetricia;2718;1;2719;2707;0;2707;0;2707;15876;13214;43;50;36;20;83;23;2014;2121;HOSPITAL GENERAL DE AGUDOS DONACION F. SANTOJANNI;
Tocoginecologia;Subtotal Tocoginecologia;2718;1;2719;2707;0;2707;0;2707;15876;13214;43;50;36;20;83;23;2014;2121;HOSPITAL GENERAL DE AGUDOS DONACION F. SANTOJANNI;
Urgencia;Terapia Intermedia;15;27;42;9;3;12;31;43;2672;162;7;32;0;44;6;6;2014;2121;HOSPITAL GENERAL DE AGUDOS DONACION F. SANTOJANNI;
Urgencia;Terapia Intensiva;96;197;293;7;104;111;182;293;4380;3592;12;0;9;84;82;1;2014;2121;HOSPITAL GENERAL DE AGUDOS DONACION F. SANTOJANNI;
Urgencia;Observación ;432;157;589;91;213;304;289;593;2924;1932;8;1;5;29;66;7;2014;2121;HOSPITAL GENERAL DE AGUDOS DONACION F. SANTOJANNI;
Urgencia;Subtotal Urgencia;543;381;924;107;320;427;502;929;9976;5686;27;33;15;58;57;0;2014;2121;HOSPITAL GENERAL DE AGUDOS DONACION F. SANTOJANNI;
Urgencia;Total Hospital;11129;1499;12628;10554;595;11149;1499;12648;127086;86693;348;18;237;52;68;22;2014;2121;HOSPITAL GENERAL DE AGUDOS DONACION F. SANTOJANNI;
Medicina;Cuidados Paliativos;120;39;159;90;66;156;2;158;1463;1341;4;1;3;67;91;66;2014;2124;HOSPITAL GENERAL DE AGUDOS DR. E. TORNU;
Medicina;Clínica Médica;637;1017;1654;1336;150;1486;175;1661;19119;17485;52;38;47;90;91;45;2014;2124;HOSPITAL GENERAL DE AGUDOS DR. E. TORNU;
Medicina;Neumotisiología;156;363;519;430;16;446;77;523;14919;5045;40;87;13;82;33;82;2014;2124;HOSPITAL GENERAL DE AGUDOS DR. E. TORNU;
Medicina;Subtotal Medicina;913;1419;2332;1856;232;2088;254;2342;35501;23871;97;26;65;40;67;24;2014;2124;HOSPITAL GENERAL DE AGUDOS DR. E. TORNU;
Cirugia;Cirugía General;465;299;764;704;5;709;55;764;8706;4690;23;85;12;85;53;87;2014;2124;HOSPITAL GENERAL DE AGUDOS DR. E. TORNU;
Cirugia;Cirugía Toracica;54;61;115;78;0;78;37;115;2152;630;5;90;1;73;29;28;2014;2124;HOSPITAL GENERAL DE AGUDOS DR. E. TORNU;
Cirugia;Ginecología;175;10;185;176;0;176;9;185;504;504;1;38;1;38;100;0;2014;2124;HOSPITAL GENERAL DE AGUDOS DR. E. TORNU;
Cirugia;Ortopedia Y Traumatología;50;133;183;150;5;155;18;173;4439;2690;12;16;7;37;60;60;2014;2124;HOSPITAL GENERAL DE AGUDOS DR. E. TORNU;
Cirugia;Urología;188;28;216;202;1;203;15;218;838;838;2;30;2;30;100;0;2014;2124;HOSPITAL GENERAL DE AGUDOS DR. E. TORNU;
Cirugia;Subtotal Cirugia;932;531;1463;1310;11;1321;134;1455;16639;9352;45;59;25;62;56;21;2014;2124;HOSPITAL GENERAL DE AGUDOS DR. E. TORNU;
Urgencia;Terapia Intermedia;4;224;228;103;33;136;93;229;4169;2708;11;42;7;42;64;96;2014;2124;HOSPITAL GENERAL DE AGUDOS DR. E. TORNU;
Urgencia;Guardia Del Día;3282;51;3333;1395;84;1479;1856;3335;2213;2217;6;6;6;7;100;18;2014;2124;HOSPITAL GENERAL DE AGUDOS DR. E. TORNU;
Urgencia;Terapia Intensiva;7;273;280;42;77;119;161;280;3834;2611;10;50;7;15;68;10;2014;2124;HOSPITAL GENERAL DE AGUDOS DR. E. TORNU;
Urgencia;Subtotal Urgencia;3293;548;3841;1540;194;1734;2110;3844;10216;7536;27;99;20;65;73;77;2014;2124;HOSPITAL GENERAL DE AGUDOS DR. E. TORNU;
Urgencia;Total Hospital;5138;2498;7636;4706;437;5143;2498;7641;62356;40759;170;84;111;67;65;37;2014;2124;HOSPITAL GENERAL DE AGUDOS DR. E. TORNU;
Medicina;Cardiología;56;40;96;78;0;78;23;101;945;820;2;59;2;25;86;77;2014;2120;HOSPITAL GENERAL DE AGUDOS D. VELEZ SARSFIELD;
Cirugia;Cirugía General;496;6;502;494;0;494;8;502;5831;2252;1598;617;3862;449;3142;0;2013;2114;INSTITUTO DE REHABILITACION PSICOFISICA (I.R.E.P.);
Cirugia;Subtotal Cirugia;496;6;502;494;0;494;8;502;5831;2252;1598;617;3862;449;3142;0;2013;2114;INSTITUTO DE REHABILITACION PSICOFISICA (I.R.E.P.);
Cirugia;Total Hospital;561;10;571;562;1;563;10;573;16751;6713;4589;1839;4008;1192;1227;18;2013;2114;INSTITUTO DE REHABILITACION PSICOFISICA (I.R.E.P.);
Medicina;Terapia Prolongada;928;59;987;802;6;808;179;987;3449;2584;945;708;7492;262;10445;61;2013;2115;HOSPITAL DE REHABILITACION RESPIRATORIA MARIA FERRER;
Medicina;Terapia Intermedia;548;261;809;636;39;675;136;811;7228;5758;198;1578;7966;71;4095;481;2013;2115;HOSPITAL DE REHABILITACION RESPIRATORIA MARIA FERRER;
Medicina;Subtotal Medicina;1476;320;1796;1438;45;1483;315;1798;10677;8342;2925;2285;7813;464;6147;25;2013;2115;HOSPITAL DE REHABILITACION RESPIRATORIA MARIA FERRER;
Urgencia;Terapia Intensiva;101;246;347;63;35;98;251;349;2864;2176;785;596;7598;623;4448;1003;2013;2115;HOSPITAL DE REHABILITACION RESPIRATORIA MARIA FERRER;
Urgencia;Subtotal Urgencia;101;246;347;63;35;98;251;349;2864;2176;785;596;7598;623;4448;1003;2013;2115;HOSPITAL DE REHABILITACION RESPIRATORIA MARIA FERRER;
Urgencia;Total Hospital;1577;566;2143;1501;80;1581;566;2147;13541;10518;371;2882;7768;665;4262;506;2013;2115;HOSPITAL DE REHABILITACION RESPIRATORIA MARIA FERRER;
Medicina;Cardiología;27;231;258;177;12;189;72;261;3670;1756;10;5;4;81;47;85;2014;2126;HOSPITAL GENERAL DE AGUDOS DR. T. ALVAREZ;
Medicina;Clínica Médica;226;1021;1247;949;132;1081;157;1238;19819;17494;54;30;47;93;88;27;2014;2126;HOSPITAL GENERAL DE AGUDOS DR. T. ALVAREZ;
Medicina;Neurología;3;17;20;18;1;19;1;20;367;342;1;1;0;94;93;19;2014;2126;HOSPITAL GENERAL DE AGUDOS DR. T. ALVAREZ;
Medicina;Psicopatologia Y Salud Mental;16;59;75;62;0;62;6;68;6504;5800;17;82;15;89;89;18;2014;2126;HOSPITAL GENERAL DE AGUDOS DR. T. ALVAREZ;
Medicina;Unidad Coronaria;43;193;236;108;20;128;105;233;1956;1418;5;36;3;88;72;49;2014;2126;HOSPITAL GENERAL DE AGUDOS DR. T. ALVAREZ;
Medicina;Subtotal Medicina;315;1521;1836;1314;165;1479;341;1820;32316;26810;88;54;73;45;82;96;2014;2126;HOSPITAL GENERAL DE AGUDOS DR. T. ALVAREZ;
Cirugia;Cirugía General;506;488;994;895;8;903;108;1011;10780;7745;29;53;21;22;71;85;2014;2126;HOSPITAL GENERAL DE AGUDOS DR. T. ALVAREZ;
Cirugia;Ginecología;153;43;196;173;0;173;21;194;1468;1179;4;2;3;23;80;31;2014;2126;HOSPITAL GENERAL DE AGUDOS DR. T. ALVAREZ;
Cirugia;Ortopedia Y Traumatología;231;210;441;388;4;392;52;444;8074;5451;22;12;14;93;67;51;2014;2126;HOSPITAL GENERAL DE AGUDOS DR. T. ALVAREZ;
Cirugia;Urología;81;21;102;77;0;77;25;102;734;418;2;1;1;15;56;95;2014;2126;HOSPITAL GENERAL DE AGUDOS DR. T. ALVAREZ;
Cirugia;Subtotal Cirugia;971;762;1733;1533;12;1545;206;1751;21056;14793;57;69;40;53;70;26;2014;2126;HOSPITAL GENERAL DE AGUDOS DR. T. ALVAREZ;
Pediatria;Recien Nacido Sano;1353;252;1605;1482;0;1482;128;1610;7093;4250;19;43;11;64;59;92;2014;2126;HOSPITAL GENERAL DE AGUDOS DR. T. ALVAREZ;
Pediatria;Neonatología;437;127;564;308;2;310;253;563;3431;2418;9;40;6;62;70;48;2014;2126;HOSPITAL GENERAL DE AGUDOS DR. T. ALVAREZ;
Pediatria;Pediatría;1138;2;1140;1141;0;1141;0;1141;8895;3567;24;37;9;77;40;10;2014;2126;HOSPITAL GENERAL DE AGUDOS DR. T. ALVAREZ;
Pediatria;Subtotal Pediatria;2928;381;3309;2931;2;2933;381;3314;19419;10235;53;20;28;4;52;71;2014;2126;HOSPITAL GENERAL DE AGUDOS DR. T. ALVAREZ;
Tocoginecologia;Obstetricia;2122;17;2139;2101;0;2101;41;2142;9553;6548;26;17;17;94;68;54;2014;2126;HOSPITAL GENERAL DE AGUDOS DR. T. ALVAREZ;
Tocoginecologia;Subtotal Tocoginecologia;2122;17;2139;2101;0;2101;41;2142;9553;6548;26;17;17;94;68;54;2014;2126;HOSPITAL GENERAL DE AGUDOS DR. T. ALVAREZ;
Urgencia;Guardia Del Día;2526;37;2563;612;120;732;1833;2565;3293;2057;9;2;5;64;62;47;2014;2126;HOSPITAL GENERAL DE AGUDOS DR. T. ALVAREZ;
Urgencia;Terapia Intensiva;7;227;234;18;74;92;143;235;2936;1969;8;4;5;39;67;6;2014;2126;HOSPITAL GENERAL DE AGUDOS DR. T. ALVAREZ;
Urgencia;Subtotal Urgencia;2533;264;2797;630;194;824;1976;2800;6229;4026;17;7;11;3;64;63;2014;2126;HOSPITAL GENERAL DE AGUDOS DR. T. ALVAREZ;
Urgencia;Total Hospital;8869;2945;11814;8509;373;8882;2945;11827;88573;62412;242;67;170;99;70;46;2014;2126;HOSPITAL GENERAL DE AGUDOS DR. T. ALVAREZ;
Medicina;Cardiología Intervencionista;266;0;266;266;0;266;0;266;484;266;1;33;0;73;54;96;2014;2122;HOSPITAL GENERAL DE AGUDOS DR C. ARGERICH;
Medicina;Cardiología;208;337;545;449;9;458;87;545;8462;6693;23;18;18;34;79;9;2014;2122;HOSPITAL GENERAL DE AGUDOS DR C. ARGERICH;
Medicina;Clínica Médica;260;371;631;467;46;513;120;633;12425;11071;34;4;30;33;89;10;2014;2122;HOSPITAL GENERAL DE AGUDOS DR C. ARGERICH;
Medicina;Unidad Coronaria;245;144;389;45;43;88;302;390;2810;2270;7;70;6;22;80;78;2014;2122;HOSPITAL GENERAL DE AGUDOS DR C. ARGERICH;
Medicina;Subtotal Medicina;979;852;1831;1227;98;1325;509;1834;24181;20300;66;25;55;62;83;95;2014;2122;HOSPITAL GENERAL DE AGUDOS DR C. ARGERICH;
Cirugia;Cirugía General;2643;178;2821;2664;29;2693;130;2823;19947;17312;54;65;47;43;86;79;2014;2122;HOSPITAL GENERAL DE AGUDOS DR C. ARGERICH;
Cirugia;Cirugía Cardiovascular;177;79;256;163;5;168;85;253;5840;4194;16;0;11;49;71;82;2014;2122;HOSPITAL GENERAL DE AGUDOS DR C. ARGERICH;
Cirugia;Ginecología;274;26;300;288;1;289;13;302;4758;4135;13;4;11;33;86;91;2014;2122;HOSPITAL GENERAL DE AGUDOS DR C. ARGERICH;
Cirugia;Neurocirugía;210;125;335;248;13;261;76;337;8395;6885;23;0;18;86;82;1;2014;2122;HOSPITAL GENERAL DE AGUDOS DR C. ARGERICH;
Cirugia;Ortopedia Y Traumatología;424;41;465;431;8;439;16;455;8052;5972;22;6;16;36;74;17;2014;2122;HOSPITAL GENERAL DE AGUDOS DR C. ARGERICH;
Cirugia;Urología;339;30;369;352;0;352;15;367;3294;3212;9;2;8;80;97;51;2014;2122;HOSPITAL GENERAL DE AGUDOS DR C. ARGERICH;
Cirugia;Trasplante Renal;456;54;510;460;11;471;37;508;7547;4782;20;68;13;10;63;36;2014;2122;HOSPITAL GENERAL DE AGUDOS DR C. ARGERICH;
Cirugia;Subtotal Cirugia;4523;533;5056;4606;67;4673;372;5045;57833;46492;158;45;127;38;80;39;2014;2122;HOSPITAL GENERAL DE AGUDOS DR C. ARGERICH;
Pediatria;Recien Nacido Sano;2191;255;2446;2049;0;2049;387;2436;13103;5716;35;90;15;66;43;62;2014;2122;HOSPITAL GENERAL DE AGUDOS DR C. ARGERICH;
Pediatria;Neonatología;378;387;765;470;29;499;262;761;9856;5876;27;0;16;10;59;62;2014;2122;HOSPITAL GENERAL DE AGUDOS DR C. ARGERICH;
Pediatria;Pediatría;532;14;546;543;2;545;0;545;6588;3372;18;5;9;24;51;18;2014;2122;HOSPITAL GENERAL DE AGUDOS DR C. ARGERICH;
Pediatria;Subtotal Pediatria;3101;656;3757;3062;31;3093;649;3742;29547;14964;80;95;41;0;50;64;2014;2122;HOSPITAL GENERAL DE AGUDOS DR C. ARGERICH;
Tocoginecologia;Obstetricia;3053;19;3072;3026;0;3026;29;3055;13523;10737;37;5;29;42;79;40;2014;2122;HOSPITAL GENERAL DE AGUDOS DR C. ARGERICH;
Tocoginecologia;Subtotal Tocoginecologia;3053;19;3072;3026;0;3026;29;3055;13523;10737;37;5;29;42;79;40;2014;2122;HOSPITAL GENERAL DE AGUDOS DR C. ARGERICH;
Urgencia;Guardia Del Día;1426;12;1438;779;165;944;493;1437;8103;8103;22;20;22;20;100;0;2014;2122;HOSPITAL GENERAL DE AGUDOS DR C. ARGERICH;
Urgencia;Terapia Intensiva;195;465;660;44;131;175;485;660;7353;6209;20;15;17;1;84;44;2014;2122;HOSPITAL GENERAL DE AGUDOS DR C. ARGERICH;
Urgencia;Subtotal Urgencia;1621;477;2098;823;296;1119;978;2097;15456;14312;42;35;39;21;92;60;2014;2122;HOSPITAL GENERAL DE AGUDOS DR C. ARGERICH;
Urgencia;Total Hospital;13277;2537;15814;12744;492;13236;2537;15773;140540;106805;385;4;292;62;76;0;2014;2122;HOSPITAL GENERAL DE AGUDOS DR C. ARGERICH;
Medicina;Cardiología;63;206;269;176;6;182;93;275;5390;2990;14;77;8;19;55;47;2014;2123;HOSPITAL GENERAL DE AGUDOS DR. C. DURAND;
Medicina;Clínica Médica;714;286;1000;795;82;877;129;1006;16799;13923;46;2;38;15;82;88;2014;2123;HOSPITAL GENERAL DE AGUDOS DR. C. DURAND;
Medicina;Geriatría;156;108;264;187;55;242;25;267;8031;6572;22;0;18;1;81;83;2014;2123;HOSPITAL GENERAL DE AGUDOS DR. C. DURAND;
Medicina;Unidad Coronaria;227;98;325;101;29;130;193;323;2558;2027;7;1;5;55;79;24;2014;2123;HOSPITAL GENERAL DE AGUDOS DR. C. DURAND;
Medicina;Subtotal Medicina;1160;698;1858;1259;172;1431;440;1871;32778;25512;89;80;69;90;77;83;2014;2123;HOSPITAL GENERAL DE AGUDOS DR. C. DURAND;
Cirugia;Cirugía General;717;111;828;737;1;738;96;834;3603;3631;9;87;9;95;100;78;2014;2123;HOSPITAL GENERAL DE AGUDOS DR. C. DURAND;
Cirugia;Cirugía Cardiovascular;65;69;134;39;11;50;85;135;1441;608;3;95;1;67;42;19;2014;2123;HOSPITAL GENERAL DE AGUDOS DR. C. DURAND;
Cirugia;Cirugía Plástica Y Reparadora - niÃ±os;33;2;35;35;0;35;0;35;102;102;0;28;0;28;100;0;2014;2123;HOSPITAL GENERAL DE AGUDOS DR. C. DURAND;
Cirugia;Oftalmología;4;0;4;4;0;4;0;4;9;9;0;2;0;2;100;0;2014;2123;HOSPITAL GENERAL DE AGUDOS DR. C. DURAND;
Cirugia;Ortopedia Y Traumatología;381;38;419;386;6;392;34;426;3738;3741;10;24;10;25;100;8;2014;2123;HOSPITAL GENERAL DE AGUDOS DR. C. DURAND;
Cirugia;Otorrinolaringología;102;2;104;102;0;102;2;104;366;366;1;0;1;0;100;0;2014;2123;HOSPITAL GENERAL DE AGUDOS DR. C. DURAND;
Cirugia;Urología;303;34;337;303;1;304;31;335;1047;1046;2;87;2;87;99;90;2014;2123;HOSPITAL GENERAL DE AGUDOS DR. C. DURAND;
Cirugia;Vascular Periférico;41;24;65;37;1;38;25;63;702;697;1;92;1;91;99;29;2014;2123;HOSPITAL GENERAL DE AGUDOS DR. C. DURAND;
Cirugia;Subtotal Cirugia;1646;280;1926;1643;20;1663;273;1936;11008;10200;30;16;27;95;92;66;2014;2123;HOSPITAL GENERAL DE AGUDOS DR. C. DURAND;
Pediatria;Recien Nacido Sano;1527;147;1674;1647;0;1647;25;1672;9166;5906;25;11;16;18;64;43;2014;2123;HOSPITAL GENERAL DE AGUDOS DR. C. DURAND;
Pediatria;Neonatología;382;176;558;245;15;260;303;563;6998;4279;19;17;11;72;61;15;2014;2123;HOSPITAL GENERAL DE AGUDOS DR. C. DURAND;
Pediatria;Pediatría;846;33;879;848;0;848;33;881;8515;4245;23;33;11;63;49;85;2014;2123;HOSPITAL GENERAL DE AGUDOS DR. C. DURAND;
Pediatria;Subtotal Pediatria;2755;356;3111;2740;15;2755;361;3116;24679;14430;67;61;39;53;58;47;2014;2123;HOSPITAL GENERAL DE AGUDOS DR. C. DURAND;
Tocoginecologia;Tocoginecología;2746;41;2787;2739;1;2740;44;2784;16753;12038;45;90;32;98;71;86;2014;2123;HOSPITAL GENERAL DE AGUDOS DR. C. DURAND;
Tocoginecologia;Subtotal Tocoginecologia;2746;41;2787;2739;1;2740;44;2784;16753;12038;45;90;32;98;71;86;2014;2123;HOSPITAL GENERAL DE AGUDOS DR. C. DURAND;
Urgencia;Terapia Intermedia;61;32;93;63;5;68;24;92;2632;1706;7;21;4;67;64;82;2014;2123;HOSPITAL GENERAL DE AGUDOS DR. C. DURAND;
Urgencia;Cuidados Intermedios;54;163;217;21;14;35;183;218;1847;1665;5;6;4;56;90;15;2014;2123;HOSPITAL GENERAL DE AGUDOS DR. C. DURAND;
Urgencia;Guardia Del Día;433;20;453;165;47;212;241;453;3142;2687;8;61;7;36;85;52;2014;2123;HOSPITAL GENERAL DE AGUDOS DR. C. DURAND;
Urgencia;Terapia Intensiva;118;222;340;9;86;95;246;341;3591;3107;9;84;8;51;86;52;2014;2123;HOSPITAL GENERAL DE AGUDOS DR. C. DURAND;
Urgencia;Subtotal Urgencia;666;437;1103;258;152;410;694;1104;11212;9165;30;72;25;11;81;74;2014;2123;HOSPITAL GENERAL DE AGUDOS DR. C. DURAND;
Urgencia;Total Hospital;8973;1812;10785;8639;360;8999;1812;10811;96430;71345;264;19;195;47;73;99;2014;2123;HOSPITAL GENERAL DE AGUDOS DR. C. DURAND;
Medicina;Cardiología;146;202;348;230;6;236;114;350;2160;1779;5;92;4;87;82;36;2014;2127;HOSPITAL GENERAL DE AGUDOS DR. J. A. FERNANDEZ;
Medicina;Clínica Médica;1087;506;1593;1149;170;1319;283;1602;27761;26034;76;6;71;33;93;78;2014;2127;HOSPITAL GENERAL DE AGUDOS DR. J. A. FERNANDEZ;
Medicina;Unidad Coronaria;424;71;495;248;40;288;208;496;3343;2333;9;16;6;39;69;79;2014;2127;HOSPITAL GENERAL DE AGUDOS DR. J. A. FERNANDEZ;
Medicina;Subtotal Medicina;1657;779;2436;1627;216;1843;605;2448;33264;30146;91;13;82;59;90;63;2014;2127;HOSPITAL GENERAL DE AGUDOS DR. J. A. FERNANDEZ;
Cirugia;Cirugía General;813;288;1101;844;14;858;242;1100;15291;14114;41;89;38;67;92;30;2014;2127;HOSPITAL GENERAL DE AGUDOS DR. J. A. FERNANDEZ;
Cirugia;Ginecología;601;305;906;759;20;779;128;907;6931;5706;18;99;15;63;82;33;2014;2127;HOSPITAL GENERAL DE AGUDOS DR. J. A. FERNANDEZ;
Cirugia;Neurocirugía;161;125;286;194;1;195;90;285;4376;4033;11;99;11;5;92;16;2014;2127;HOSPITAL GENERAL DE AGUDOS DR. J. A. FERNANDEZ;
Cirugia;Ortopedia Y Traumatología;1022;126;1148;969;3;972;187;1159;15786;13092;43;25;35;87;82;93;2014;2127;HOSPITAL GENERAL DE AGUDOS DR. J. A. FERNANDEZ;
Cirugia;Urología;232;41;273;207;6;213;61;274;3566;3293;9;77;9;2;92;34;2014;2127;HOSPITAL GENERAL DE AGUDOS DR. J. A. FERNANDEZ;
Cirugia;Subtotal Cirugia;2829;885;3714;2973;44;3017;708;3725;45950;40238;125;89;110;24;87;57;2014;2127;HOSPITAL GENERAL DE AGUDOS DR. J. A. FERNANDEZ;
Pediatria;Recien Nacido Sano;1601;18;1619;1507;0;1507;108;1615;10188;4656;27;91;12;76;45;70;2014;2127;HOSPITAL GENERAL DE AGUDOS DR. J. A. FERNANDEZ;
Pediatria;Neonatología;400;108;508;469;27;496;19;515;8058;6353;22;8;17;41;78;84;2014;2127;HOSPITAL GENERAL DE AGUDOS DR. J. A. FERNANDEZ;
Pediatria;Pediatría;806;1;807;806;0;806;0;806;6323;3460;17;32;9;48;54;72;2014;2127;HOSPITAL GENERAL DE AGUDOS DR. J. A. FERNANDEZ;
Pediatria;Subtotal Pediatria;2807;127;2934;2782;27;2809;127;2936;24569;14469;67;31;39;64;58;89;2014;2127;HOSPITAL GENERAL DE AGUDOS DR. J. A. FERNANDEZ;
Tocoginecologia;Obstetricia;2374;10;2384;2097;0;2097;287;2384;10966;7736;30;4;21;19;70;55;2014;2127;HOSPITAL GENERAL DE AGUDOS DR. J. A. FERNANDEZ;
Tocoginecologia;Subtotal Tocoginecologia;2374;10;2384;2097;0;2097;287;2384;10966;7736;30;4;21;19;70;55;2014;2127;HOSPITAL GENERAL DE AGUDOS DR. J. A. FERNANDEZ;
Urgencia;Terapia Intermedia;42;257;299;32;26;58;240;298;4277;4047;11;72;11;9;94;62;2014;2127;HOSPITAL GENERAL DE AGUDOS DR. J. A. FERNANDEZ;
Urgencia;Toxicología;189;9;198;188;0;188;10;198;2585;1519;7;8;4;16;58;76;2014;2127;HOSPITAL GENERAL DE AGUDOS DR. J. A. FERNANDEZ;
Urgencia;Terapia Intensiva;203;315;518;11;106;117;405;522;5926;5454;16;24;14;94;92;4;2014;2127;HOSPITAL GENERAL DE AGUDOS DR. J. A. FERNANDEZ;
Urgencia;Subtotal Urgencia;434;581;1015;231;132;363;655;1018;12788;11020;35;4;30;19;86;17;2014;2127;HOSPITAL GENERAL DE AGUDOS DR. J. A. FERNANDEZ;
Urgencia;Total Hospital;10101;2382;12483;9710;419;10129;2382;12511;127537;103609;349;42;283;86;81;24;2014;2127;HOSPITAL GENERAL DE AGUDOS DR. J. A. FERNANDEZ;
Medicina;Clínica Médica;72;506;578;444;74;518;62;580;17614;16081;48;26;44;6;91;30;2014;2161;HOSPITAL GENERAL DE AGUDOS J. A. PENNA;
Medicina;Subtotal Medicina;72;506;578;444;74;518;62;580;17614;16081;48;26;44;6;91;30;2014;2161;HOSPITAL GENERAL DE AGUDOS J. A. PENNA;
Cirugia;Cirugía General;992;374;1366;1289;15;1304;59;1363;12245;8062;33;55;22;9;65;84;2014;2161;HOSPITAL GENERAL DE AGUDOS J. A. PENNA;
Cirugia;Ortopedia Y Traumatología;93;163;256;234;6;240;15;255;6516;6083;17;85;16;67;93;35;2014;2161;HOSPITAL GENERAL DE AGUDOS J. A. PENNA;
Cirugia;Urología;269;37;306;286;0;286;21;307;2401;2266;6;58;6;21;94;38;2014;2161;HOSPITAL GENERAL DE AGUDOS J. A. PENNA;
Cirugia;Subtotal Cirugia;1354;574;1928;1809;21;1830;95;1925;21162;16411;57;98;44;96;77;55;2014;2161;HOSPITAL GENERAL DE AGUDOS J. A. PENNA;
Pediatria;Recien Nacido Sano;3111;563;3674;3432;0;3432;239;3671;17790;13561;48;74;37;15;76;23;2014;2161;HOSPITAL GENERAL DE AGUDOS J. A. PENNA;
Pediatria;Neonatología;721;186;907;368;30;398;516;914;8561;6259;23;45;17;15;73;11;2014;2161;HOSPITAL GENERAL DE AGUDOS J. A. PENNA;
Pediatria;Pediatría;953;9;962;961;0;961;2;963;8271;4619;22;66;12;65;55;85;2014;2161;HOSPITAL GENERAL DE AGUDOS J. A. PENNA;
Pediatria;Subtotal Pediatria;4785;758;5543;4761;30;4791;757;5548;34622;24439;94;85;66;96;70;59;2014;2161;HOSPITAL GENERAL DE AGUDOS J. A. PENNA;
Tocoginecologia;Tocoginecología;5779;310;6089;5759;9;5768;320;6088;25541;23248;69;98;63;69;91;2;2014;2161;HOSPITAL GENERAL DE AGUDOS J. A. PENNA;
Tocoginecologia;Subtotal Tocoginecologia;5779;310;6089;5759;9;5768;320;6088;25541;23248;69;98;63;69;91;2;2014;2161;HOSPITAL GENERAL DE AGUDOS J. A. PENNA;
Urgencia;Terapia Intermedia;0;181;181;16;25;41;141;182;1617;1617;4;43;4;43;100;0;2014;2161;HOSPITAL GENERAL DE AGUDOS J. A. PENNA;
Urgencia;Guardia Del Día;2592;1;2593;1417;187;1604;994;2598;8928;8926;24;46;24;45;99;98;2014;2161;HOSPITAL GENERAL DE AGUDOS J. A. PENNA;
Urgencia;Terapia Intensiva;4;146;150;7;35;42;107;149;1627;1561;4;46;4;28;95;94;2014;2161;HOSPITAL GENERAL DE AGUDOS J. A. PENNA;
Urgencia;Subtotal Urgencia;2596;328;2924;1440;247;1687;1242;2929;12172;12104;33;35;33;16;99;44;2014;2161;HOSPITAL GENERAL DE AGUDOS J. A. PENNA;
Urgencia;Total Hospital;14586;2476;17062;14213;381;14594;2476;17070;111111;92283;304;41;252;83;83;5;2014;2161;HOSPITAL GENERAL DE AGUDOS J. A. PENNA;
Medicina;Psicopatologia Y Salud Mental;226;75;301;285;0;285;3;288;7300;5038;20;0;13;80;69;1;2014;2163;HOSPITAL GENERAL DE AGUDOS P. PIÑERO;
Medicina;Subtotal Medicina;226;75;301;285;0;285;3;288;7300;5038;20;0;13;80;69;1;2014;2163;HOSPITAL GENERAL DE AGUDOS P. PIÑERO;
Cirugia;Ginecología;423;28;451;424;1;425;29;454;2971;1520;8;14;4;16;51;16;2014;2163;HOSPITAL GENERAL DE AGUDOS P. PIÑERO;
Cirugia;Subtotal Cirugia;423;28;451;424;1;425;29;454;2971;1520;8;14;4;16;51;16;2014;2163;HOSPITAL GENERAL DE AGUDOS P. PIÑERO;
Pediatria;Recien Nacido Sano;2824;0;2824;2444;0;2444;384;2828;9470;8052;25;95;22;6;85;3;2014;2163;HOSPITAL GENERAL DE AGUDOS P. PIÑERO;
Pediatria;Neonatología;77;384;461;435;16;451;4;455;6702;4469;18;36;12;24;66;68;2014;2163;HOSPITAL GENERAL DE AGUDOS P. PIÑERO;
Pediatria;Pediatría;956;9;965;967;0;967;1;968;8698;4517;23;83;12;38;51;93;2014;2163;HOSPITAL GENERAL DE AGUDOS P. PIÑERO;
Pediatria;Subtotal Pediatria;3857;393;4250;3846;16;3862;389;4251;24870;17038;68;14;46;68;68;51;2014;2163;HOSPITAL GENERAL DE AGUDOS P. PIÑERO;
Tocoginecologia;Obstetricia;3510;88;3598;3517;0;3517;90;3607;15096;12686;41;36;34;76;84;4;2014;2163;HOSPITAL GENERAL DE AGUDOS P. PIÑERO;
Tocoginecologia;Subtotal Tocoginecologia;3510;88;3598;3517;0;3517;90;3607;15096;12686;41;36;34;76;84;4;2014;2163;HOSPITAL GENERAL DE AGUDOS P. PIÑERO;
Urgencia;Guardia Del Día;3236;67;3303;1122;191;1313;1996;3309;4575;4545;12;53;12;45;99;34;2014;2163;HOSPITAL GENERAL DE AGUDOS P. PIÑERO;
Urgencia;Terapia Intensiva;7;234;241;9;70;79;164;243;2889;2106;7;92;5;77;72;90;2014;2163;HOSPITAL GENERAL DE AGUDOS P. PIÑERO;
Urgencia;Subtotal Urgencia;3243;301;3544;1131;261;1392;2160;3552;7464;6651;20;45;18;22;89;11;2014;2163;HOSPITAL GENERAL DE AGUDOS P. PIÑERO;
Area Indiferenciada;Area Indiferenciada;941;2094;3035;2486;242;2728;308;3036;53195;38479;145;74;105;42;72;34;2014;2163;HOSPITAL GENERAL DE AGUDOS P. PIÑERO;
Area Indiferenciada;Subtotal Area Indiferenciada;941;2094;3035;2486;242;2728;308;3036;53195;38479;145;74;105;42;72;34;2014;2163;HOSPITAL GENERAL DE AGUDOS P. PIÑERO;
Area Indiferenciada;Total Hospital;12200;2979;15179;11689;520;12209;2979;15188;110896;81412;303;82;223;5;73;41;2014;2163;HOSPITAL GENERAL DE AGUDOS P. PIÑERO;
Medicina;Cardiología;0;29;29;21;0;21;8;29;730;88;2;0;0;24;12;5;2014;2125;HOSPITAL GENERAL DE AGUDOS DR. I. PIROVANO;
Medicina;Clínica Médica;1074;279;1353;1016;204;1220;135;1355;22187;19959;60;79;54;68;89;96;2014;2125;HOSPITAL GENERAL DE AGUDOS DR. I. PIROVANO;
Medicina;Unidad Coronaria;203;33;236;174;12;186;52;238;2190;1812;6;0;4;96;82;74;2014;2125;HOSPITAL GENERAL DE AGUDOS DR. I. PIROVANO;
Medicina;Subtotal Medicina;1277;341;1618;1211;216;1427;195;1622;25107;21859;68;79;59;89;87;6;2014;2125;HOSPITAL GENERAL DE AGUDOS DR. I. PIROVANO;
Cirugia;Cirugía General;1313;136;1449;1281;56;1337;110;1447;19304;14274;52;89;39;11;73;94;2014;2125;HOSPITAL GENERAL DE AGUDOS DR. I. PIROVANO;
Cirugia;Ginecología;736;63;799;698;13;711;91;802;5547;5191;15;20;14;22;93;58;2014;2125;HOSPITAL GENERAL DE AGUDOS DR. I. PIROVANO;
Cirugia;Neurocirugía;225;96;321;209;3;212;104;316;5821;3871;15;95;10;61;66;50;2014;2125;HOSPITAL GENERAL DE AGUDOS DR. I. PIROVANO;
Urgencia;Subtotal Urgencia;1666;632;2298;806;334;1140;1156;2296;16411;15340;4496;4203;9347;668;5107;1455;2015;2122;HOSPITAL GENERAL DE AGUDOS DR C. ARGERICH;
Urgencia;Total Hospital;12945;2584;15529;12401;542;12943;2584;15527;141551;109801;38781;30082;7757;848;3337;419;2015;2122;HOSPITAL GENERAL DE AGUDOS DR C. ARGERICH;
sticas de Salud - MSGC;Fuente : Movimiento Hospitalario;2015;;;;;;;;;;2015;;;;;;2015;2122;HOSPITAL GENERAL DE AGUDOS DR C. ARGERICH;
Medicina;Cardiología;58;189;247;147;2;149;99;248;5516;2689;1511;737;4875;1084;1641;81;2015;2123;HOSPITAL GENERAL DE AGUDOS DR. C. DURAND;
Medicina;Clínica Médica;594;351;945;766;55;821;116;937;16790;13423;46;3678;7995;1433;2037;587;2015;2123;HOSPITAL GENERAL DE AGUDOS DR. C. DURAND;
Medicina;Geriatría;93;100;193;134;42;176;13;189;8419;7825;2307;2144;9294;414;819;2222;2015;2123;HOSPITAL GENERAL DE AGUDOS DR. C. DURAND;
Medicina;Unidad Coronaria;258;114;372;155;37;192;180;372;2563;1843;702;505;7191;495;5298;995;2015;2123;HOSPITAL GENERAL DE AGUDOS DR. C. DURAND;
Medicina;Subtotal Medicina;1003;754;1757;1202;136;1338;408;1746;33288;25780;912;7063;7745;1477;1914;779;2015;2123;HOSPITAL GENERAL DE AGUDOS DR. C. DURAND;
Cirugia;Cirugía General;761;149;910;786;2;788;116;904;3977;3991;109;1093;10035;441;8297;22;2015;2123;HOSPITAL GENERAL DE AGUDOS DR. C. DURAND;
Cirugia;Cirugía Cardiovascular;49;55;104;37;13;50;54;104;1429;878;392;241;6144;844;2656;125;2015;2123;HOSPITAL GENERAL DE AGUDOS DR. C. DURAND;
Cirugia;Cirugía Plástica Y Reparadora - niÃ±os;51;0;51;51;0;51;0;51;135;114;37;31;8444;224;13789;0;2015;2123;HOSPITAL GENERAL DE AGUDOS DR. C. DURAND;
Cirugia;Oftalmología;8;0;8;7;0;7;1;8;25;25;7;7;100;313;1168;0;2015;2123;HOSPITAL GENERAL DE AGUDOS DR. C. DURAND;
Cirugia;Ortopedia Y Traumatología;395;33;428;386;6;392;36;428;3883;3887;1064;1065;1001;908;4023;14;2015;2123;HOSPITAL GENERAL DE AGUDOS DR. C. DURAND;
Cirugia;Otorrinolaringología;71;0;71;71;0;71;0;71;279;279;76;76;100;393;9289;0;2015;2123;HOSPITAL GENERAL DE AGUDOS DR. C. DURAND;
Cirugia;Urología;308;23;331;314;0;314;19;333;963;966;264;265;10031;29;12621;0;2015;2123;HOSPITAL GENERAL DE AGUDOS DR. C. DURAND;
Cirugia;Vascular Periférico;21;11;32;25;0;25;9;34;521;516;143;141;9904;1518;2382;0;2015;2123;HOSPITAL GENERAL DE AGUDOS DR. C. DURAND;
Cirugia;Subtotal Cirugia;1664;271;1935;1677;21;1698;235;1933;11212;10656;3072;2919;9504;551;6293;109;2015;2123;HOSPITAL GENERAL DE AGUDOS DR. C. DURAND;
Pediatria;Recien Nacido Sano;1271;93;1364;1333;0;1333;37;1370;9133;4659;2502;1276;5101;34;5475;0;2015;2123;HOSPITAL GENERAL DE AGUDOS DR. C. DURAND;
Pediatria;Neonatología;331;171;502;265;6;271;232;503;7307;4870;2002;1334;6665;968;2513;119;2015;2123;HOSPITAL GENERAL DE AGUDOS DR. C. DURAND;
Pediatria;Pediatría;903;51;954;926;0;926;24;950;8476;4532;2322;1242;5347;477;4091;0;2015;2123;HOSPITAL GENERAL DE AGUDOS DR. C. DURAND;
Pediatria;Subtotal Pediatria;2505;315;2820;2524;6;2530;293;2823;24916;14061;6826;3852;5643;498;4135;21;2015;2123;HOSPITAL GENERAL DE AGUDOS DR. C. DURAND;
Tocoginecologia;Tocoginecología;2376;50;2426;2378;0;2378;55;2433;15218;10352;4169;2836;6802;425;5835;0;2015;2123;HOSPITAL GENERAL DE AGUDOS DR. C. DURAND;
Tocoginecologia;Subtotal Tocoginecologia;2376;50;2426;2378;0;2378;55;2433;15218;10352;4169;2836;6802;425;5835;0;2015;2123;HOSPITAL GENERAL DE AGUDOS DR. C. DURAND;
Urgencia;Terapia Intermedia;50;23;73;23;5;28;48;76;2920;1697;8;465;5812;2233;95;658;2015;2123;HOSPITAL GENERAL DE AGUDOS DR. C. DURAND;
Urgencia;Cuidados Intermedios;42;154;196;20;11;31;166;197;1830;1734;501;475;9475;88;3929;558;2015;2123;HOSPITAL GENERAL DE AGUDOS DR. C. DURAND;
Urgencia;Guardia Del Día;730;32;762;239;124;363;396;759;4314;4207;1182;1153;9752;554;6422;1634;2015;2123;HOSPITAL GENERAL DE AGUDOS DR. C. DURAND;
Urgencia;Terapia Intensiva;84;245;329;7;81;88;243;331;3110;2755;852;755;8859;832;3885;2447;2015;2123;HOSPITAL GENERAL DE AGUDOS DR. C. DURAND;
Urgencia;Subtotal Urgencia;906;454;1360;289;221;510;853;1363;12174;10393;3335;2847;8537;763;4087;1621;2015;2123;HOSPITAL GENERAL DE AGUDOS DR. C. DURAND;
Urgencia;Total Hospital;8454;1844;10298;8070;384;8454;1844;10298;96808;71242;26523;19518;7359;843;3187;454;2015;2123;HOSPITAL GENERAL DE AGUDOS DR. C. DURAND;
sticas de Salud - MSGC;Fuente : Movimiento Hospitalario;2015;;;;;;;;;;2015;;;;;;2015;2123;HOSPITAL GENERAL DE AGUDOS DR. C. DURAND;
Medicina;Cardiología;140;207;347;221;8;229;116;345;2211;2002;606;548;9055;58;5695;232;2015;2127;HOSPITAL GENERAL DE AGUDOS DR. J. A. FERNANDEZ;
Medicina;Clínica Médica;1038;483;1521;1119;134;1253;269;1522;27887;26597;764;7287;9537;1748;1992;88;2015;2127;HOSPITAL GENERAL DE AGUDOS DR. J. A. FERNANDEZ;
Medicina;Unidad Coronaria;460;85;545;279;43;322;225;547;3285;2464;9;675;7501;45;6078;786;2015;2127;HOSPITAL GENERAL DE AGUDOS DR. J. A. FERNANDEZ;
Medicina;Subtotal Medicina;1638;775;2413;1619;185;1804;610;2414;33383;31063;9146;851;9305;1287;2639;766;2015;2127;HOSPITAL GENERAL DE AGUDOS DR. J. A. FERNANDEZ;
Cirugia;Cirugía General;756;242;998;809;12;821;184;1005;15305;13946;4193;3821;9112;1388;2397;119;2015;2127;HOSPITAL GENERAL DE AGUDOS DR. J. A. FERNANDEZ;
Cirugia;Ginecología;650;334;984;794;7;801;179;980;6728;5420;1843;1485;8056;553;5317;71;2015;2127;HOSPITAL GENERAL DE AGUDOS DR. J. A. FERNANDEZ;
Cirugia;Neurocirugía;150;120;270;185;1;186;87;273;4229;3970;1159;1088;9388;1454;2356;37;2015;2127;HOSPITAL GENERAL DE AGUDOS DR. J. A. FERNANDEZ;
Cirugia;Ortopedia Y Traumatología;1016;122;1138;986;7;993;140;1133;14992;12583;4107;3447;8393;1111;2758;62;2015;2127;HOSPITAL GENERAL DE AGUDOS DR. J. A. FERNANDEZ;
Cirugia;Urología;228;23;251;198;1;199;52;251;3507;3299;961;904;9407;1314;2612;4;2015;2127;HOSPITAL GENERAL DE AGUDOS DR. J. A. FERNANDEZ;
Cirugia;Subtotal Cirugia;2800;841;3641;2972;28;3000;642;3642;44761;39218;12263;10745;8762;1077;297;77;2015;2127;HOSPITAL GENERAL DE AGUDOS DR. J. A. FERNANDEZ;
Pediatria;Recien Nacido Sano;1437;41;1478;1371;0;1371;107;1478;10200;4329;2795;1186;4244;293;5289;0;2015;2127;HOSPITAL GENERAL DE AGUDOS DR. J. A. FERNANDEZ;
Pediatria;Neonatología;363;110;473;397;25;422;44;466;8050;5994;2205;1642;7446;1286;2113;536;2015;2127;HOSPITAL GENERAL DE AGUDOS DR. J. A. FERNANDEZ;
Pediatria;Pediatría;809;4;813;806;0;806;5;811;6567;3673;1799;1006;5593;453;4508;0;2015;2127;HOSPITAL GENERAL DE AGUDOS DR. J. A. FERNANDEZ;
Pediatria;Subtotal Pediatria;2609;155;2764;2574;25;2599;156;2755;24817;13996;6799;3835;564;508;4052;91;2015;2127;HOSPITAL GENERAL DE AGUDOS DR. J. A. FERNANDEZ;
Tocoginecologia;Obstetricia;2235;13;2248;1930;0;1930;313;2243;10682;7180;2927;1967;6722;32;7664;0;2015;2127;HOSPITAL GENERAL DE AGUDOS DR. J. A. FERNANDEZ;
Tocoginecologia;Subtotal Tocoginecologia;2235;13;2248;1930;0;1930;313;2243;10682;7180;2927;1967;6722;32;7664;0;2015;2127;HOSPITAL GENERAL DE AGUDOS DR. J. A. FERNANDEZ;
Urgencia;Terapia Intermedia;33;210;243;28;11;39;204;243;4303;4109;1179;1126;9549;1691;2061;453;2015;2127;HOSPITAL GENERAL DE AGUDOS DR. J. A. FERNANDEZ;
Urgencia;Toxicología;211;5;216;204;0;204;9;213;2760;1601;756;439;5801;752;2817;0;2015;2127;HOSPITAL GENERAL DE AGUDOS DR. J. A. FERNANDEZ;
Urgencia;Terapia Intensiva;155;293;448;11;81;92;358;450;4730;4519;1296;1238;9554;1004;3473;18;2015;2127;HOSPITAL GENERAL DE AGUDOS DR. J. A. FERNANDEZ;
Urgencia;Subtotal Urgencia;399;508;907;243;92;335;571;906;11793;10229;3231;2802;8674;1129;2804;1015;2015;2127;HOSPITAL GENERAL DE AGUDOS DR. J. A. FERNANDEZ;
Urgencia;Total Hospital;9681;2292;11973;9338;330;9668;2292;11960;125436;101686;34366;27859;8107;1052;2813;341;2015;2127;HOSPITAL GENERAL DE AGUDOS DR. J. A. FERNANDEZ;
sticas de Salud - MSGC;Fuente : Movimiento Hospitalario;2015;;;;;;;;;;2015;;;;;;2015;2127;HOSPITAL GENERAL DE AGUDOS DR. J. A. FERNANDEZ;
Medicina;Clínica Médica;78;474;552;425;76;501;56;557;17583;16398;4817;4493;9326;2944;1156;1364;2015;2161;HOSPITAL GENERAL DE AGUDOS J. A. PENNA;
Medicina;Subtotal Medicina;78;474;552;425;76;501;56;557;17583;16398;4817;4493;9326;2944;1156;1364;2015;2161;HOSPITAL GENERAL DE AGUDOS J. A. PENNA;
Cirugia;Cirugía General;1151;181;1332;1230;16;1246;85;1331;13152;8136;3603;2229;6186;611;3694;12;2015;2161;HOSPITAL GENERAL DE AGUDOS J. A. PENNA;
Cirugia;Ortopedia Y Traumatología;146;135;281;266;8;274;14;288;6244;5945;1711;1629;9521;2064;1684;278;2015;2161;HOSPITAL GENERAL DE AGUDOS J. A. PENNA;
Cirugia;Urología;260;37;297;275;1;276;20;296;2692;2610;738;715;9695;882;4013;34;2015;2161;HOSPITAL GENERAL DE AGUDOS J. A. PENNA;
Cirugia;Subtotal Cirugia;1557;353;1910;1771;25;1796;119;1915;22088;16691;6052;4573;7557;872;3165;131;2015;2161;HOSPITAL GENERAL DE AGUDOS J. A. PENNA;
Pediatria;Recien Nacido Sano;2980;407;3387;3200;0;3200;189;3389;17656;12251;4837;3356;6939;361;7006;0;2015;2161;HOSPITAL GENERAL DE AGUDOS J. A. PENNA;
Pediatria;Neonatología;547;155;702;315;15;330;375;705;8400;5079;2301;1392;6046;72;3063;213;2015;2161;HOSPITAL GENERAL DE AGUDOS J. A. PENNA;
Pediatria;Pediatría;1100;9;1109;1108;1;1109;3;1112;8401;4759;2302;1304;5665;428;4831;9;2015;2161;HOSPITAL GENERAL DE AGUDOS J. A. PENNA;
Pediatria;Subtotal Pediatria;4627;571;5198;4623;16;4639;567;5206;34457;22089;944;6052;6411;424;5515;31;2015;2161;HOSPITAL GENERAL DE AGUDOS J. A. PENNA;
Tocoginecologia;Tocoginecología;5265;195;5460;5259;1;5260;201;5461;24983;21138;6845;5791;8461;387;7978;2;2015;2161;HOSPITAL GENERAL DE AGUDOS J. A. PENNA;
Tocoginecologia;Subtotal Tocoginecologia;5265;195;5460;5259;1;5260;201;5461;24983;22089;6845;5791;8461;387;7978;2;2015;2161;HOSPITAL GENERAL DE AGUDOS J. A. PENNA;
Urgencia;Terapia Intermedia;16;192;208;8;48;56;150;206;1658;1658;454;454;100;805;4535;233;2015;2161;HOSPITAL GENERAL DE AGUDOS J. A. PENNA;
Urgencia;Guardia Del Día;2400;2;2402;1501;178;1679;725;2404;9477;9467;2596;2594;9989;394;9259;74;2015;2161;HOSPITAL GENERAL DE AGUDOS J. A. PENNA;
Urgencia;Terapia Intensiva;18;130;148;6;44;50;99;149;1990;1989;545;545;9995;1335;2733;2953;2015;2161;HOSPITAL GENERAL DE AGUDOS J. A. PENNA;
Urgencia;Subtotal Urgencia;2434;324;2758;1515;270;1785;974;2759;13125;13114;3596;3593;9992;475;7673;979;2015;2161;HOSPITAL GENERAL DE AGUDOS J. A. PENNA;
Cuidados Grales - Area Indiferenciada;Sector 5;691;236;927;890;1;891;33;924;8123;6486;22;25;17;77;79;85;2014;2172;HOSPITAL GENERAL DE NIÑOS PEDRO DE ELIZALDE;
Cuidados Grales - Area Indiferenciada;Sector 6 A;489;120;609;535;8;543;64;607;4452;2918;12;20;7;99;65;54;2014;2172;HOSPITAL GENERAL DE NIÑOS PEDRO DE ELIZALDE;
Cuidados Grales - Area Indiferenciada;Sector 6 B - Presión Positiva;276;60;336;279;0;279;54;333;2885;1832;7;90;5;2;63;50;2014;2172;HOSPITAL GENERAL DE NIÑOS PEDRO DE ELIZALDE;
Cuidados Grales - Area Indiferenciada;Sector 7;1932;162;2094;1975;0;1975;120;2095;9765;6466;26;75;17;72;66;22;2014;2172;HOSPITAL GENERAL DE NIÑOS PEDRO DE ELIZALDE;
Cuidados Grales - Area Indiferenciada;Subtotal Cuidados Grales - Area Indiferenciada;6008;1605;7613;7119;9;7128;491;7619;57916;44923;158;67;123;8;77;57;2014;2172;HOSPITAL GENERAL DE NIÑOS PEDRO DE ELIZALDE;
Cuidados Especiales;Neonatología Alta Complejidad;88;27;115;16;15;31;82;113;4368;2571;11;97;7;4;58;86;2014;2172;HOSPITAL GENERAL DE NIÑOS PEDRO DE ELIZALDE;
Cuidados Especiales;Neonatología Mediana Complejidad;147;80;227;200;0;200;29;229;4384;2433;12;1;6;67;55;50;2014;2172;HOSPITAL GENERAL DE NIÑOS PEDRO DE ELIZALDE;
Cuidados Especiales;Cuidados Intermedios;102;128;230;87;4;91;139;230;2918;2080;7;99;5;70;71;28;2014;2172;HOSPITAL GENERAL DE NIÑOS PEDRO DE ELIZALDE;
Cuidados Especiales;Cuidados Intensivos;135;154;289;9;19;28;266;294;4009;2173;10;98;5;95;54;20;2014;2172;HOSPITAL GENERAL DE NIÑOS PEDRO DE ELIZALDE;
Cuidados Especiales;Cirugía Cardiovascular;112;33;145;121;13;134;11;145;3076;1614;8;43;4;42;52;47;2014;2172;HOSPITAL GENERAL DE NIÑOS PEDRO DE ELIZALDE;
Cuidados Especiales;Guardia;2317;0;2317;1296;2;1298;1017;2315;2985;2573;8;18;7;5;86;20;2014;2172;HOSPITAL GENERAL DE NIÑOS PEDRO DE ELIZALDE;
Cuidados Especiales;Subtotal Cuidados Especiales;2901;422;3323;1729;53;1782;1544;3326;21740;13444;59;56;36;83;61;84;2014;2172;HOSPITAL GENERAL DE NIÑOS PEDRO DE ELIZALDE;
Cuidados Especiales;Total Hospital;8937;2035;10972;8879;62;8941;2035;10976;82672;59533;226;50;163;10;72;1;2014;2172;HOSPITAL GENERAL DE NIÑOS PEDRO DE ELIZALDE;
Medicina;Pediatria;3104;477;3581;3149;5;3154;438;3592;35190;28756;96;41;78;78;81;72;2014;2164;HOSPITAL GENERAL DE NIÑOS RICARDO GUTIERREZ;
Medicina;Endocrinología;226;0;226;226;0;226;0;226;2208;226;6;5;0;62;10;24;2014;2164;HOSPITAL GENERAL DE NIÑOS RICARDO GUTIERREZ;
Medicina;Infecciosas;511;151;662;558;10;568;97;665;8843;8140;24;23;22;30;92;5;2014;2164;HOSPITAL GENERAL DE NIÑOS RICARDO GUTIERREZ;
Medicina;Neonatología;251;31;282;237;12;249;37;286;6662;5127;18;25;14;5;76;96;2014;2164;HOSPITAL GENERAL DE NIÑOS RICARDO GUTIERREZ;
Medicina;Centro Respiratorio;217;99;316;217;1;218;101;319;4422;3686;12;12;10;10;83;36;2014;2164;HOSPITAL GENERAL DE NIÑOS RICARDO GUTIERREZ;
Medicina;Nefrología;360;26;386;365;0;365;25;390;4416;2070;12;10;5;67;46;88;2014;2164;HOSPITAL GENERAL DE NIÑOS RICARDO GUTIERREZ;
Medicina;Subtotal Medicina;4669;784;5453;4752;28;4780;698;5478;61741;48005;169;15;131;52;77;75;2014;2164;HOSPITAL GENERAL DE NIÑOS RICARDO GUTIERREZ;
Cirugia;Cirugía General;1563;184;1747;1546;0;1546;208;1754;10439;5979;28;60;16;38;57;28;2014;2164;HOSPITAL GENERAL DE NIÑOS RICARDO GUTIERREZ;
Cirugia;Cirugía Cardiovascular;292;49;341;289;13;302;35;337;6253;5038;17;13;13;80;80;57;2014;2164;HOSPITAL GENERAL DE NIÑOS RICARDO GUTIERREZ;
Cirugia;Cirugía Plástica Y Reparadora - niÃ±os;512;24;536;510;0;510;30;540;2960;1480;8;11;4;5;50;0;2014;2164;HOSPITAL GENERAL DE NIÑOS RICARDO GUTIERREZ;
Cirugia;Neurocirugía;377;87;464;371;1;372;87;459;8464;3262;23;19;8;94;38;54;2014;2164;HOSPITAL GENERAL DE NIÑOS RICARDO GUTIERREZ;
Cirugia;Ortopedia Y Traumatología;1196;119;1315;1171;0;1171;135;1306;13004;6415;35;63;17;58;49;33;2014;2164;HOSPITAL GENERAL DE NIÑOS RICARDO GUTIERREZ;
Cirugia;Urologia;271;11;282;273;0;273;9;282;4771;1528;13;7;4;19;32;3;2014;2164;HOSPITAL GENERAL DE NIÑOS RICARDO GUTIERREZ;
Cirugia;Quemados NiÃ±os;61;1;62;55;0;55;3;58;279;117;0;76;0;32;41;94;2014;2164;HOSPITAL GENERAL DE NIÑOS RICARDO GUTIERREZ;
Cirugia;Subtotal Cirugia;4272;475;4747;4215;14;4229;507;4736;46170;23819;126;49;65;26;51;59;2014;2164;HOSPITAL GENERAL DE NIÑOS RICARDO GUTIERREZ;
Urgencia;Terapia Intermedia;26;175;201;11;1;12;189;201;1570;635;4;30;1;74;40;45;2014;2164;HOSPITAL GENERAL DE NIÑOS RICARDO GUTIERREZ;
Urgencia;Terapia Intensiva;99;232;331;12;49;61;272;333;5554;4579;15;22;12;55;82;45;2014;2164;HOSPITAL GENERAL DE NIÑOS RICARDO GUTIERREZ;
Urgencia;Subtotal Urgencia;125;407;532;23;50;73;461;534;7124;5214;19;52;14;28;73;19;2014;2164;HOSPITAL GENERAL DE NIÑOS RICARDO GUTIERREZ;
Urgencia;Total Hospital;9066;1666;10732;8990;92;9082;1666;10748;115035;77038;315;16;211;6;66;97;2014;2164;HOSPITAL GENERAL DE NIÑOS RICARDO GUTIERREZ;
Pediatria;Recien Nacido Sano;4973;553;5526;4862;0;4862;647;5509;25175;15941;68;97;43;67;63;32;2014;2167;HOSPITAL MATERNO INFANTIL R. SARDA;
Pediatria;Neonatología;1230;1184;2414;1246;79;1325;1090;2415;29565;14994;81;0;41;8;50;72;2014;2167;HOSPITAL MATERNO INFANTIL R. SARDA;
Pediatria;Subtotal Pediatria;6203;1737;7940;6108;79;6187;1737;7924;54740;30935;149;97;84;75;56;51;2014;2167;HOSPITAL MATERNO INFANTIL R. SARDA;
Tocoginecologia;Tocoginecología;7362;169;7531;7418;0;7418;103;7521;36847;28613;100;95;78;39;77;65;2014;2167;HOSPITAL MATERNO INFANTIL R. SARDA;
Tocoginecologia;Subtotal Tocoginecologia;7362;169;7531;7418;0;7418;103;7521;36847;28613;100;95;78;39;77;65;2014;2167;HOSPITAL MATERNO INFANTIL R. SARDA;
Urgencia;Terapia Intermedia;8;12;20;10;0;10;10;20;594;72;1;63;0;20;12;12;2014;2167;HOSPITAL MATERNO INFANTIL R. SARDA;
Urgencia;Terapia Intensiva;77;33;110;10;0;10;101;111;1126;429;3;8;1;18;38;10;2014;2167;HOSPITAL MATERNO INFANTIL R. SARDA;
Urgencia;Subtotal Urgencia;85;45;130;20;0;20;111;131;1720;501;4;71;1;37;29;13;2014;2167;HOSPITAL MATERNO INFANTIL R. SARDA;
Urgencia;Total Hospital;13650;1951;15601;13546;79;13625;1951;15576;93307;60049;255;64;164;52;64;36;2014;2167;HOSPITAL MATERNO INFANTIL R. SARDA;
Medicina;Dermatología;377;18;395;346;1;347;57;404;12154;6898;33;30;18;90;56;75;2014;2110;HOSPITAL DE INFECCIOSAS F. MUÑIZ;
Medicina;Infecciosas;1480;333;1813;1458;88;1546;273;1819;43115;28739;118;12;78;74;66;66;2014;2110;HOSPITAL DE INFECCIOSAS F. MUÑIZ;
Medicina;Hepatopatía;271;32;303;223;9;232;69;301;4768;1866;13;6;5;11;39;14;2014;2110;HOSPITAL DE INFECCIOSAS F. MUÑIZ;
Medicina;Neumotisiología;430;84;514;421;15;436;79;515;19246;15242;52;73;41;76;79;20;2014;2110;HOSPITAL DE INFECCIOSAS F. MUÑIZ;
Medicina;Asistencia Respiratoria Intermedia;212;378;590;83;108;191;402;593;4886;3529;13;39;9;67;72;23;2014;2110;HOSPITAL DE INFECCIOSAS F. MUÑIZ;
Medicina;Zoopatología Médica;288;81;369;303;2;305;60;365;6347;3291;17;39;9;2;51;85;2014;2110;HOSPITAL DE INFECCIOSAS F. MUÑIZ;
Medicina;Subtotal Medicina;3058;926;3984;2834;223;3057;940;3997;90516;59565;247;99;163;19;65;81;2014;2110;HOSPITAL DE INFECCIOSAS F. MUÑIZ;
Cirugia;Cirugía General;591;110;701;596;5;601;97;698;10438;3564;28;60;9;76;34;14;2014;2110;HOSPITAL DE INFECCIOSAS F. MUÑIZ;
Cirugia;Subtotal Cirugia;591;110;701;596;5;601;97;698;10438;3564;28;60;9;76;34;14;2014;2110;HOSPITAL DE INFECCIOSAS F. MUÑIZ;
Pediatria;Infecciosas Pediatría;484;35;519;487;0;487;32;519;12380;4775;33;92;13;8;38;57;2014;2110;HOSPITAL DE INFECCIOSAS F. MUÑIZ;
Pediatria;Subtotal Pediatria;484;35;519;487;0;487;32;519;12380;4775;33;92;13;8;38;57;2014;2110;HOSPITAL DE INFECCIOSAS F. MUÑIZ;
Urgencia;Terapia Intensiva;128;163;291;19;109;128;165;293;2627;1909;7;20;5;23;72;67;2014;2110;HOSPITAL DE INFECCIOSAS F. MUÑIZ;
Urgencia;Subtotal Urgencia;128;163;291;19;109;128;165;293;2627;1909;7;20;5;23;72;67;2014;2110;HOSPITAL DE INFECCIOSAS F. MUÑIZ;
Urgencia;Total Hospital;4261;1234;5495;3936;337;4273;1234;5507;115961;69813;317;70;191;27;60;20;2014;2110;HOSPITAL DE INFECCIOSAS F. MUÑIZ;
Medicina;Curieterapia;56;0;56;55;0;55;1;56;1085;224;2;97;0;61;20;65;2014;2168;HOSPITAL MUNICIPAL DE ONCOLOGIA MARIE CURIE;
Medicina;Medicina;1634;10;1644;1173;449;1622;33;1655;20876;18961;57;19;51;95;90;83;2014;2168;HOSPITAL MUNICIPAL DE ONCOLOGIA MARIE CURIE;
Medicina;Subtotal Medicina;1690;10;1700;1228;449;1677;34;1711;21961;19185;60;17;52;56;87;36;2014;2168;HOSPITAL MUNICIPAL DE ONCOLOGIA MARIE CURIE;
Cirugia;Cirugía General;715;33;748;720;21;741;9;750;8958;3928;24;54;10;76;43;85;2014;2168;HOSPITAL MUNICIPAL DE ONCOLOGIA MARIE CURIE;
Cirugia;Subtotal Cirugia;715;33;748;720;21;741;9;750;8958;3928;24;54;10;76;43;85;2014;2168;HOSPITAL MUNICIPAL DE ONCOLOGIA MARIE CURIE;
Cirugia;Total Hospital;2405;43;2448;1948;470;2418;43;2461;30919;23113;84;71;63;32;74;75;2014;2168;HOSPITAL MUNICIPAL DE ONCOLOGIA MARIE CURIE;
Cirugia;Cirugía Plástica;534;39;573;533;0;533;40;573;2761;666;7;56;1;82;24;12;2014;2112;HOSPITAL DE QUEMADOS DR. ARTURO UMBERTO ILLIA;
Cirugia;Quemados ;6;145;151;97;1;98;56;154;3415;2976;9;36;8;15;87;14;2014;2112;HOSPITAL DE QUEMADOS DR. ARTURO UMBERTO ILLIA;
Cirugia;Quemados-Cuidados Grales - Adultos;69;158;227;194;0;194;30;224;5104;3370;;;;;;;2014;2112;HOSPITAL DE QUEMADOS DR. ARTURO UMBERTO ILLIA;
Cirugia;Quemados-Cuidados Interm.- Adultos;1;19;20;13;0;13;4;17;335;305;;;;;;;2014;2112;HOSPITAL DE QUEMADOS DR. ARTURO UMBERTO ILLIA;
Cirugia;Subtotal Cirugia;610;361;971;837;1;838;130;968;11615;7317;31;82;20;5;63;0;2014;2112;HOSPITAL DE QUEMADOS DR. ARTURO UMBERTO ILLIA;
Pediatria;Quemados ;72;327;399;230;0;230;172;402;4606;3972;12;62;10;88;86;24;2014;2112;HOSPITAL DE QUEMADOS DR. ARTURO UMBERTO ILLIA;
Pediatria;Quemados-Cuidados Grales- Pediatría;25;159;184;173;0;173;6;179;2258;1261;;;;;;;2014;2112;HOSPITAL DE QUEMADOS DR. ARTURO UMBERTO ILLIA;
Pediatria;Subtotal Pediatria;97;486;583;403;0;403;178;581;6864;5233;18;81;14;34;76;24;2014;2112;HOSPITAL DE QUEMADOS DR. ARTURO UMBERTO ILLIA;
Urgencia;Guardia;662;2;664;48;1;49;615;664;1095;186;3;0;0;51;16;99;2014;2112;HOSPITAL DE QUEMADOS DR. ARTURO UMBERTO ILLIA;
Urgencia;Quemados Cuidados Intensivos-Adultos;1;88;89;4;34;38;50;88;2185;1712;;;;;;;2014;2112;HOSPITAL DE QUEMADOS DR. ARTURO UMBERTO ILLIA;
Urgencia;Terapia Intensiva;1;86;87;35;4;39;50;89;3526;1448;9;66;3;97;41;7;2014;2112;HOSPITAL DE QUEMADOS DR. ARTURO UMBERTO ILLIA;
Urgencia;Subtotal Urgencia;664;176;840;87;39;126;715;841;6806;3346;18;65;9;17;49;16;2014;2112;HOSPITAL DE QUEMADOS DR. ARTURO UMBERTO ILLIA;
Urgencia;Total Hospital;1371;1023;2394;1327;40;1367;1023;2390;25285;15896;69;27;43;55;62;87;2014;2112;HOSPITAL DE QUEMADOS DR. ARTURO UMBERTO ILLIA;
Medicina;Hepatología;64;24;88;47;5;52;40;92;1400;1205;3;84;3;30;86;7;2014;2109;HOSPITAL DE GASTROENTEROLOGIA B. UDAONDO;
Medicina;Clínica Médica;666;183;849;537;65;602;229;831;13173;11185;36;9;30;64;84;91;2014;2109;HOSPITAL DE GASTROENTEROLOGIA B. UDAONDO;
Medicina;Subtotal Medicina;730;207;937;584;70;654;269;923;14573;12390;39;93;33;95;85;2;2014;2109;HOSPITAL DE GASTROENTEROLOGIA B. UDAONDO;
Cirugia;Cirugía;1263;362;1625;1362;15;1377;256;1633;12046;8704;33;0;23;85;72;26;2014;2109;HOSPITAL DE GASTROENTEROLOGIA B. UDAONDO;
Cirugia;Subtotal Cirugia;1263;362;1625;1362;15;1377;256;1633;12046;8704;33;0;23;85;72;26;2014;2109;HOSPITAL DE GASTROENTEROLOGIA B. UDAONDO;
Urgencia;Terapia Intensiva;104;171;275;6;47;53;215;268;2371;1675;6;50;4;59;70;65;2014;2109;HOSPITAL DE GASTROENTEROLOGIA B. UDAONDO;
Urgencia;Subtotal Urgencia;104;171;275;6;47;53;215;268;2371;1675;6;50;4;59;70;65;2014;2109;HOSPITAL DE GASTROENTEROLOGIA B. UDAONDO;
Urgencia;Total Hospital;2097;740;2837;1952;132;2084;740;2824;28990;22769;79;42;62;38;78;54;2014;2109;HOSPITAL DE GASTROENTEROLOGIA B. UDAONDO;
Cirugia;Oftalmología;2485;0;2485;2487;0;2487;0;2487;10300;3054;28;22;8;37;29;65;2014;2169;HOSPITAL OFTALMOLOGICO DR. PEDRO LAGLEYZE;
Cirugia;Subtotal Cirugia;2485;0;2485;2487;0;2487;0;2487;10300;3054;28;22;8;37;29;65;2014;2169;HOSPITAL OFTALMOLOGICO DR. PEDRO LAGLEYZE;
Cirugia;Total Hospital;2485;0;2485;2487;0;2487;0;2487;10300;3054;28;22;8;37;29;65;2014;2169;HOSPITAL OFTALMOLOGICO DR. PEDRO LAGLEYZE;
Cirugia;Neurocirugía;55;31;86;53;0;53;35;88;6570;494;18;0;1;35;7;52;2014;2111;HOSPITAL DE OFTALMOLOGIA SANTA LUCIA;
Cirugia;Oftalmología;4434;2;4436;4447;0;4447;1;4448;9728;3247;26;65;8;90;33;38;2014;2111;HOSPITAL DE OFTALMOLOGIA SANTA LUCIA;
Cirugia;Subtotal Cirugia;4489;33;4522;4500;0;4500;36;4536;16298;3741;44;65;10;25;22;95;2014;2111;HOSPITAL DE OFTALMOLOGIA SANTA LUCIA;
Urgencia;Terapia Intensiva;1;32;33;3;0;3;29;32;1095;227;3;0;0;62;20;73;2014;2111;HOSPITAL DE OFTALMOLOGIA SANTA LUCIA;
Urgencia;Subtotal Urgencia;1;32;33;3;0;3;29;32;1095;227;3;0;0;62;20;73;2014;2111;HOSPITAL DE OFTALMOLOGIA SANTA LUCIA;
Urgencia;Total Hospital;4490;65;4555;4503;0;4503;65;4568;17393;3968;47;65;10;87;22;81;2014;2111;HOSPITAL DE OFTALMOLOGIA SANTA LUCIA;
Medicina;Clínica Médica;0;184;184;21;2;23;69;92;11680;9010;32;0;24;68;77;14;2014;2117;HOSPITAL DE SALUD MENTAL J. T. BORDA;
Medicina;Neurología;0;11;11;2;0;2;4;6;4039;2159;11;7;5;92;53;45;2014;2117;HOSPITAL DE SALUD MENTAL J. T. BORDA;
Medicina;Psicopatologia Y Salud Mental;894;707;1601;840;7;847;849;1696;257668;213569;705;94;585;12;82;89;2014;2117;HOSPITAL DE SALUD MENTAL J. T. BORDA;
Medicina;Subtotal Medicina;894;902;1796;863;9;872;922;1794;273387;224738;749;1;615;72;82;21;2014;2117;HOSPITAL DE SALUD MENTAL J. T. BORDA;
Cirugia;Cirugía General;0;34;34;12;2;14;14;28;3650;2305;10;0;6;32;63;15;2014;2117;HOSPITAL DE SALUD MENTAL J. T. BORDA;
Cirugia;Subtotal Cirugia;0;34;34;12;2;14;14;28;3650;2305;10;0;6;32;63;15;2014;2117;HOSPITAL DE SALUD MENTAL J. T. BORDA;
Cirugia;Total Hospital;894;936;1830;875;11;886;936;1822;277037;227043;759;1;622;4;81;95;2014;2117;HOSPITAL DE SALUD MENTAL J. T. BORDA;
Medicina;Clínica Médica;0;36;36;8;15;23;13;36;8395;3598;23;0;9;86;42;86;2014;2116;HOSPITAL DE SALUD MENTAL BRAULIO MOYANO;
Medicina;Psicopatologia Y Salud Mental;1054;934;1988;1045;10;1055;967;2022;320903;278224;879;19;762;26;86;70;2014;2116;HOSPITAL DE SALUD MENTAL BRAULIO MOYANO;
Medicina;Subtotal Medicina;1054;970;2024;1053;25;1078;980;2058;329298;281822;902;19;772;12;85;58;2014;2116;HOSPITAL DE SALUD MENTAL BRAULIO MOYANO;
Cirugia;Cirugía General;0;56;56;9;1;10;49;59;5840;2512;16;0;6;88;43;1;2014;2116;HOSPITAL DE SALUD MENTAL BRAULIO MOYANO;
Cirugia;Ginecología;0;10;10;0;0;0;7;7;5840;622;16;0;1;70;10;65;2014;2116;HOSPITAL DE SALUD MENTAL BRAULIO MOYANO;
Cirugia;Subtotal Cirugia;0;66;66;9;1;10;56;66;11680;3134;32;0;8;59;26;83;2014;2116;HOSPITAL DE SALUD MENTAL BRAULIO MOYANO;
Cirugia;Total Hospital;1054;1036;2090;1062;26;1088;1036;2124;340978;284956;934;19;780;70;83;57;2014;2116;HOSPITAL DE SALUD MENTAL BRAULIO MOYANO;
Pediatria;Psiquiatria;368;19;387;377;0;377;13;390;23007;12315;63;3;33;74;53;53;2014;2165;HOSPITAL INFANTO JUVENIL C. TOBAR GARCIA;
Pediatria;Subtotal Pediatria;368;19;387;377;0;377;13;390;23007;12315;63;3;33;74;53;53;2014;2165;HOSPITAL INFANTO JUVENIL C. TOBAR GARCIA;
Pediatria;Total Hospital;368;19;387;377;0;377;13;390;23007;12315;63;3;33;74;53;53;2014;2165;HOSPITAL INFANTO JUVENIL C. TOBAR GARCIA;
Medicina;Psicopatologia Y Salud Mental;15;266;281;247;0;247;36;283;18267;17777;50;5;48;70;97;32;2014;2108;HOSPITAL DE EMERGENCIAS PSIQUIATRICAS TORCUATO DE ALVEAR;
Medicina;Adolescencia;15;29;44;41;0;41;8;49;6570;3043;18;0;8;34;46;32;2014;2108;HOSPITAL DE EMERGENCIAS PSIQUIATRICAS TORCUATO DE ALVEAR;
Medicina;Subtotal Medicina;30;295;325;288;0;288;44;332;24837;20820;68;5;57;4;83;83;2014;2108;HOSPITAL DE EMERGENCIAS PSIQUIATRICAS TORCUATO DE ALVEAR;
Urgencia;Emergencia;396;42;438;148;0;148;293;441;6159;5841;16;87;16;0;94;84;2014;2108;HOSPITAL DE EMERGENCIAS PSIQUIATRICAS TORCUATO DE ALVEAR;
Urgencia;Subtotal Urgencia;396;42;438;148;0;148;293;441;6159;5841;16;87;16;0;94;84;2014;2108;HOSPITAL DE EMERGENCIAS PSIQUIATRICAS TORCUATO DE ALVEAR;
Urgencia;Total Hospital;426;337;763;436;0;436;337;773;30996;26661;84;92;73;4;86;1;2014;2108;HOSPITAL DE EMERGENCIAS PSIQUIATRICAS TORCUATO DE ALVEAR;
Medicina;Fisiatría;75;1;76;71;1;72;1;73;25509;19008;69;89;52;8;74;51;2014;2113;HOSPITAL DE REHABILITACION M. ROCCA;
Medicina;Subtotal Medicina;75;1;76;71;1;72;1;73;25509;19008;69;89;52;8;74;51;2014;2113;HOSPITAL DE REHABILITACION M. ROCCA;
Cirugia;Cirugía General;104;1;105;106;0;106;1;107;2081;971;5;70;2;66;46;66;2014;2113;HOSPITAL DE REHABILITACION M. ROCCA;
Cirugia;Subtotal Cirugia;104;1;105;106;0;106;1;107;2081;971;5;70;2;66;46;66;2014;2113;HOSPITAL DE REHABILITACION M. ROCCA;
Cirugia;Total Hospital;179;2;181;177;1;178;2;180;27590;19979;75;59;54;74;72;41;2014;2113;HOSPITAL DE REHABILITACION M. ROCCA;
Medicina;Fisiatría;108;3;111;111;1;112;0;112;14600;5981;40;0;16;39;40;97;2014;2114;INSTITUTO DE REHABILITACION PSICOFISICA (I.R.E.P.);
Medicina;Subtotal Medicina;108;3;111;111;1;112;0;112;14600;5981;40;0;16;39;40;97;2014;2114;INSTITUTO DE REHABILITACION PSICOFISICA (I.R.E.P.);
Cirugia;Cirugía General;440;1;441;439;0;439;4;443;5912;1998;16;20;5;47;33;80;2014;2114;INSTITUTO DE REHABILITACION PSICOFISICA (I.R.E.P.);
Cirugia;Subtotal Cirugia;440;1;441;439;0;439;4;443;5912;1998;16;20;5;47;33;80;2014;2114;INSTITUTO DE REHABILITACION PSICOFISICA (I.R.E.P.);
Cirugia;Total Hospital;548;4;552;550;1;551;4;555;20512;7979;56;20;21;86;38;90;2014;2114;INSTITUTO DE REHABILITACION PSICOFISICA (I.R.E.P.);
Medicina;Terapia Prolongada;842;61;903;727;18;745;158;903;3064;2195;8;39;6;1;71;64;2014;2115;HOSPITAL DE REHABILITACION RESPIRATORIA MARIA FERRER;
Medicina;Terapia Intermedia;569;267;836;659;26;685;151;836;7547;6219;20;68;17;4;82;40;2014;2115;HOSPITAL DE REHABILITACION RESPIRATORIA MARIA FERRER;
Medicina;Subtotal Medicina;1411;328;1739;1386;44;1430;309;1739;10611;8414;29;7;23;5;79;30;2014;2115;HOSPITAL DE REHABILITACION RESPIRATORIA MARIA FERRER;
Urgencia;Terapia Intensiva;130;230;360;65;46;111;249;360;2878;2163;7;88;5;93;75;16;2014;2115;HOSPITAL DE REHABILITACION RESPIRATORIA MARIA FERRER;
Urgencia;Subtotal Urgencia;130;230;360;65;46;111;249;360;2878;2163;7;88;5;93;75;16;2014;2115;HOSPITAL DE REHABILITACION RESPIRATORIA MARIA FERRER;
Urgencia;Total Hospital;1541;558;2099;1451;90;1541;558;2099;13489;10577;36;96;28;98;78;41;2014;2115;HOSPITAL DE REHABILITACION RESPIRATORIA MARIA FERRER;
Medicina;Cardiología;16;201;217;153;10;163;52;215;3526;1558;966;427;4419;725;2226;465;2015;2126;HOSPITAL GENERAL DE AGUDOS DR. T. ALVAREZ;
Medicina;Clínica Médica;241;992;1233;983;121;1104;129;1233;22145;18631;6067;5104;8413;1511;2032;981;2015;2126;HOSPITAL GENERAL DE AGUDOS DR. T. ALVAREZ;
Medicina;Neurología;4;16;20;16;1;17;4;21;365;276;1;76;7562;1314;21;476;2015;2126;HOSPITAL GENERAL DE AGUDOS DR. T. ALVAREZ;
Medicina;Psicopatologia Y Salud Mental;15;60;75;69;0;69;6;75;7608;7055;2084;1933;9273;9407;36;0;2015;2126;HOSPITAL GENERAL DE AGUDOS DR. T. ALVAREZ;
Medicina;Unidad Coronaria;38;183;221;77;26;103;123;226;2190;1413;6;387;6452;625;3767;115;2015;2126;HOSPITAL GENERAL DE AGUDOS DR. T. ALVAREZ;
Medicina;Subtotal Medicina;314;1452;1766;1298;158;1456;314;1770;35834;28933;9818;7927;8074;1635;1803;893;2015;2126;HOSPITAL GENERAL DE AGUDOS DR. T. ALVAREZ;
Cirugia;Cirugía General;537;589;1126;967;8;975;153;1128;11411;7603;3126;2083;6663;674;3608;71;2015;2126;HOSPITAL GENERAL DE AGUDOS DR. T. ALVAREZ;
Cirugia;Ginecología;173;41;214;206;0;206;9;215;1460;1247;4;342;8541;58;5375;0;2015;2126;HOSPITAL GENERAL DE AGUDOS DR. T. ALVAREZ;
Cirugia;Ortopedia Y Traumatología;240;216;456;383;8;391;69;460;8030;5321;22;1458;6626;1157;2091;174;2015;2126;HOSPITAL GENERAL DE AGUDOS DR. T. ALVAREZ;
Cirugia;Urología;74;35;109;82;1;83;25;108;731;466;2;128;6375;431;5393;93;2015;2126;HOSPITAL GENERAL DE AGUDOS DR. T. ALVAREZ;
Cirugia;Subtotal Cirugia;1024;881;1905;1638;17;1655;256;1911;21632;14637;5927;401;6766;766;3224;89;2015;2126;HOSPITAL GENERAL DE AGUDOS DR. T. ALVAREZ;
Pediatria;Recien Nacido Sano;1331;245;1576;1425;0;1425;143;1568;7302;3932;2001;1077;5385;251;7838;0;2015;2126;HOSPITAL GENERAL DE AGUDOS DR. T. ALVAREZ;
Pediatria;Neonatología;361;141;502;248;7;255;246;501;3656;2228;1002;61;6094;445;5002;14;2015;2126;HOSPITAL GENERAL DE AGUDOS DR. T. ALVAREZ;
Pediatria;Pediatría;1235;6;1241;1242;0;1242;1;1243;9133;3328;2502;912;3644;268;4968;0;2015;2126;HOSPITAL GENERAL DE AGUDOS DR. T. ALVAREZ;
Pediatria;Subtotal Pediatria;2927;392;3319;2915;7;2922;390;3312;20091;9488;5504;2599;4723;286;6017;21;2015;2126;HOSPITAL GENERAL DE AGUDOS DR. T. ALVAREZ;
Tocoginecologia;Obstetricia;2108;15;2123;2068;0;2068;44;2112;10774;6600;2952;1808;6126;313;7155;0;2015;2126;HOSPITAL GENERAL DE AGUDOS DR. T. ALVAREZ;
Tocoginecologia;Subtotal Tocoginecologia;2108;15;2123;2068;0;2068;44;2112;10774;6600;2952;1808;6126;313;7155;0;2015;2126;HOSPITAL GENERAL DE AGUDOS DR. T. ALVAREZ;
Urgencia;Guardia Del Día;2720;38;2758;748;149;897;1856;2753;4391;2662;1203;729;6062;97;22884;541;2015;2126;HOSPITAL GENERAL DE AGUDOS DR. T. ALVAREZ;
Urgencia;Terapia Intensiva;10;233;243;14;75;89;151;240;2920;2298;8;63;787;958;30;3125;2015;2126;HOSPITAL GENERAL DE AGUDOS DR. T. ALVAREZ;
Urgencia;Subtotal Urgencia;2730;271;3001;762;224;986;2007;2993;7311;4960;2003;1359;6784;166;14942;748;2015;2126;HOSPITAL GENERAL DE AGUDOS DR. T. ALVAREZ;
Urgencia;Total Hospital;9103;3011;12114;8681;406;9087;3011;12098;95642;64618;26203;17704;6756;711;3468;447;2015;2126;HOSPITAL GENERAL DE AGUDOS DR. T. ALVAREZ;
sticas de Salud - MSGC;Fuente : Movimiento Hospitalario;2015;;;;;;;;;;2015;;;;;;2015;2126;HOSPITAL GENERAL DE AGUDOS DR. T. ALVAREZ;
Medicina;Cardiología Intervencionista;200;0;200;200;0;200;0;200;450;200;123;55;4444;1;16222;0;2015;2122;HOSPITAL GENERAL DE AGUDOS DR C. ARGERICH;
Medicina;Cardiología;184;333;517;397;12;409;107;516;8834;7022;242;1924;7949;1361;2132;233;2015;2122;HOSPITAL GENERAL DE AGUDOS DR C. ARGERICH;
Medicina;Clínica Médica;253;425;678;440;69;509;169;678;12410;11342;34;3107;9139;1673;1994;1018;2015;2122;HOSPITAL GENERAL DE AGUDOS DR C. ARGERICH;
Medicina;Unidad Coronaria;215;160;375;48;48;96;280;376;2644;2052;724;562;7761;546;5191;1277;2015;2122;HOSPITAL GENERAL DE AGUDOS DR C. ARGERICH;
Medicina;Subtotal Medicina;852;918;1770;1085;129;1214;556;1770;24338;20616;6668;5648;8471;1165;2654;729;2015;2122;HOSPITAL GENERAL DE AGUDOS DR C. ARGERICH;
Cirugia;Cirugía General;2894;188;3082;2913;36;2949;149;3098;20075;17502;55;4795;8718;565;5633;116;2015;2122;HOSPITAL GENERAL DE AGUDOS DR C. ARGERICH;
Cirugia;Cirugía Cardiovascular;179;87;266;154;7;161;104;265;5840;4337;16;1188;7426;1637;1656;264;2015;2122;HOSPITAL GENERAL DE AGUDOS DR C. ARGERICH;
Cirugia;Ginecología;258;43;301;283;3;286;15;301;4745;4358;13;1194;9184;1448;2315;1;2015;2122;HOSPITAL GENERAL DE AGUDOS DR C. ARGERICH;
Cirugia;Neurocirugía;157;107;264;192;6;198;64;262;8395;7280;23;1995;8672;2779;1139;229;2015;2122;HOSPITAL GENERAL DE AGUDOS DR C. ARGERICH;
Cirugia;Ortopedia Y Traumatología;308;86;394;356;8;364;31;395;7937;6433;2175;1762;8105;1629;1816;203;2015;2122;HOSPITAL GENERAL DE AGUDOS DR C. ARGERICH;
Cirugia;Urología;308;39;347;318;0;318;30;348;3285;3206;9;878;976;921;3867;0;2015;2122;HOSPITAL GENERAL DE AGUDOS DR C. ARGERICH;
Cirugia;Trasplante Renal;421;74;495;423;5;428;63;491;7057;5084;1933;1393;7204;1035;254;102;2015;2122;HOSPITAL GENERAL DE AGUDOS DR C. ARGERICH;
Cirugia;Subtotal Cirugia;4525;624;5149;4639;65;4704;456;5160;57334;48200;15708;13205;8407;934;3285;126;2015;2122;HOSPITAL GENERAL DE AGUDOS DR C. ARGERICH;
Pediatria;Recien Nacido Sano;1854;211;2065;1927;0;1927;133;2060;13505;5556;37;1522;4114;27;5568;0;2015;2122;HOSPITAL GENERAL DE AGUDOS DR C. ARGERICH;
Pediatria;Neonatología;585;132;717;488;14;502;214;716;9855;6106;27;1673;6196;853;2652;196;2015;2122;HOSPITAL GENERAL DE AGUDOS DR C. ARGERICH;
Pediatria;Pediatría;503;13;516;515;0;515;2;517;6570;3238;18;887;4928;626;2872;0;2015;2122;HOSPITAL GENERAL DE AGUDOS DR C. ARGERICH;
Pediatria;Subtotal Pediatria;2942;356;3298;2930;14;2944;349;3293;29930;14900;82;4082;4978;452;4016;43;2015;2122;HOSPITAL GENERAL DE AGUDOS DR C. ARGERICH;
Tocoginecologia;Obstetricia;2960;54;3014;2941;0;2941;67;3008;13538;10745;3709;2944;7937;357;811;0;2015;2122;HOSPITAL GENERAL DE AGUDOS DR C. ARGERICH;
Tocoginecologia;Subtotal Tocoginecologia;2960;54;3014;2941;0;2941;67;3008;13538;10745;3709;2944;7937;357;811;0;2015;2122;HOSPITAL GENERAL DE AGUDOS DR C. ARGERICH;
Urgencia;Guardia Del Día;1536;19;1555;757;208;965;593;1558;8534;8534;2338;2338;100;548;6664;1335;2015;2122;HOSPITAL GENERAL DE AGUDOS DR C. ARGERICH;
Urgencia;Terapia Intensiva;130;613;743;49;126;175;563;738;7877;6806;2158;1865;864;922;342;1707;2015;2122;HOSPITAL GENERAL DE AGUDOS DR C. ARGERICH;
Medicina;Clínica Médica;318;48;366;279;47;326;41;367;5572;4700;1527;1288;8435;1281;2404;1281;2015;2120;HOSPITAL GENERAL DE AGUDOS D. VELEZ SARSFIELD;
Medicina;Subtotal Medicina;361;80;441;346;50;396;48;444;6406;5288;1755;1449;8255;1191;253;1126;2015;2120;HOSPITAL GENERAL DE AGUDOS D. VELEZ SARSFIELD;
Cirugia;Cirugía General;611;55;666;611;6;617;48;665;4432;3094;1214;848;6981;465;5477;9;2015;2120;HOSPITAL GENERAL DE AGUDOS D. VELEZ SARSFIELD;
Cirugia;Ginecología;94;4;98;95;0;95;3;98;690;263;189;72;3812;268;5184;0;2015;2120;HOSPITAL GENERAL DE AGUDOS D. VELEZ SARSFIELD;
Cirugia;Oftalmología;323;;;;;;;;;;88;;;;;;2015;2120;HOSPITAL GENERAL DE AGUDOS D. VELEZ SARSFIELD;
Cirugia;Ortopedia Y Traumatología;265;17;282;245;15;260;17;277;4061;4033;1113;1105;9931;1456;249;542;2015;2120;HOSPITAL GENERAL DE AGUDOS D. VELEZ SARSFIELD;
Cirugia;Subtotal Cirugia;970;76;1046;951;21;972;68;1040;9506;7390;2604;2025;7774;711;3993;202;2015;2120;HOSPITAL GENERAL DE AGUDOS D. VELEZ SARSFIELD;
Pediatria;Recien Nacido Sano;708;361;1069;944;0;944;122;1066;6643;2594;182;711;3905;243;5857;0;2015;2120;HOSPITAL GENERAL DE AGUDOS D. VELEZ SARSFIELD;
Pediatria;Neonatología;710;121;831;466;2;468;365;833;3212;2724;88;746;8481;327;9466;24;2015;2120;HOSPITAL GENERAL DE AGUDOS D. VELEZ SARSFIELD;
Pediatria;Pediatría;631;23;654;645;0;645;11;656;5091;2111;1395;578;4147;322;4703;0;2015;2120;HOSPITAL GENERAL DE AGUDOS D. VELEZ SARSFIELD;
Pediatria;Subtotal Pediatria;2049;505;2554;2055;2;2057;498;2555;14946;7429;4095;2035;4971;291;624;8;2015;2120;HOSPITAL GENERAL DE AGUDOS D. VELEZ SARSFIELD;
Tocoginecologia;Obstetricia;1562;7;1569;1552;0;1552;16;1568;7698;4590;2109;1258;5963;293;7435;0;2015;2120;HOSPITAL GENERAL DE AGUDOS D. VELEZ SARSFIELD;
Tocoginecologia;Subtotal Tocoginecologia;1562;7;1569;1552;0;1552;16;1568;7698;4590;2109;1258;5963;293;7435;0;2015;2120;HOSPITAL GENERAL DE AGUDOS D. VELEZ SARSFIELD;
Urgencia;Terapia Intensiva;111;79;190;13;57;70;117;187;2389;2278;655;624;9535;1218;2857;3048;2015;2120;HOSPITAL GENERAL DE AGUDOS D. VELEZ SARSFIELD;
Urgencia;Subtotal Urgencia;111;79;190;13;57;70;117;187;2389;2278;655;624;9535;1218;2857;3048;2015;2120;HOSPITAL GENERAL DE AGUDOS D. VELEZ SARSFIELD;
Urgencia;Total Hospital;5053;747;5800;4917;130;5047;747;5794;40945;26975;11218;739;6588;534;4499;258;2015;2120;HOSPITAL GENERAL DE AGUDOS D. VELEZ SARSFIELD;
sticas de Salud - MSGC;Fuente : Movimiento Hospitalario;2015;;;;;;;;;;2015;;;;;;2015;2120;HOSPITAL GENERAL DE AGUDOS D. VELEZ SARSFIELD;
Medicina;Unidad Coronaria;148;30;178;97;8;105;72;177;1825;1401;5;384;7677;792;354;452;2015;2118;HOSPITAL GENERAL DE AGUDOS A. ZUBIZARRETA;
Medicina;Subtotal Medicina;148;30;178;97;8;105;72;177;1825;1401;5;384;7677;792;354;452;2015;2118;HOSPITAL GENERAL DE AGUDOS A. ZUBIZARRETA;
Pediatria;Adolescencia;99;0;99;107;0;107;0;107;2222;1255;609;344;5648;1173;1758;0;2015;2118;HOSPITAL GENERAL DE AGUDOS A. ZUBIZARRETA;
Pediatria;Pediatría;346;0;346;350;0;350;0;350;4441;3628;1217;994;8169;1037;2877;0;2015;2118;HOSPITAL GENERAL DE AGUDOS A. ZUBIZARRETA;
Pediatria;Subtotal Pediatria;445;0;445;457;0;457;0;457;6663;4883;1825;1338;7329;1068;2503;0;2015;2118;HOSPITAL GENERAL DE AGUDOS A. ZUBIZARRETA;
Urgencia;Terapia Intermedia;952;369;1321;1215;26;1241;82;1323;10950;6184;30;1694;5647;467;441;197;2015;2118;HOSPITAL GENERAL DE AGUDOS A. ZUBIZARRETA;
Urgencia;Terapia Intensiva;84;99;183;14;47;61;122;183;2190;1719;6;471;7849;939;305;2568;2015;2118;HOSPITAL GENERAL DE AGUDOS A. ZUBIZARRETA;
Urgencia;Subtotal Urgencia;1036;468;1504;1229;73;1302;204;1506;13140;7903;36;2165;6014;525;4183;485;2015;2118;HOSPITAL GENERAL DE AGUDOS A. ZUBIZARRETA;
Area Indiferenciada;Area Indiferenciada - Cuidados Alejados;1585;348;1933;1184;172;1356;570;1926;17100;12414;4685;3401;726;645;4111;893;2015;2118;HOSPITAL GENERAL DE AGUDOS A. ZUBIZARRETA;
Area Indiferenciada;Subtotal Area Indiferenciada;1585;348;1933;1184;172;1356;570;1926;17100;12414;4685;3401;726;645;4111;893;2015;2118;HOSPITAL GENERAL DE AGUDOS A. ZUBIZARRETA;
Area Indiferenciada;Total Hospital;3214;846;4060;2967;253;3220;846;4066;38728;26601;1061;7288;6869;826;3035;786;2015;2118;HOSPITAL GENERAL DE AGUDOS A. ZUBIZARRETA;
sticas de Salud - MSGC;Fuente : Movimiento Hospitalario;2015;;;;;;;;;;2015;;;;;;2015;2118;HOSPITAL GENERAL DE AGUDOS A. ZUBIZARRETA;
Medicina;Psicopatologia Y Salud Mental;35;2;37;37;0;37;1;38;3587;1975;983;541;5506;5197;387;0;2015;2172;HOSPITAL GENERAL DE NIÑOS PEDRO DE ELIZALDE;
Medicina;Subtotal Medicina;35;2;37;37;0;37;1;38;3587;1975;983;541;5506;5197;387;0;2015;2172;HOSPITAL GENERAL DE NIÑOS PEDRO DE ELIZALDE;
Cuidados Genereales - Area Indiferenciada;Sector 1;654;278;932;890;1;891;36;927;8872;7295;2431;1999;8222;787;3814;11;2015;2172;HOSPITAL GENERAL DE NIÑOS PEDRO DE ELIZALDE;
Cuidados Genereales - Area Indiferenciada;Sector 2;617;237;854;798;1;799;52;851;7868;6749;2156;1849;8578;793;3948;12;2015;2172;HOSPITAL GENERAL DE NIÑOS PEDRO DE ELIZALDE;
Cuidados Genereales - Area Indiferenciada;Sector 3 A;235;147;382;331;2;333;50;383;3496;2603;958;713;7446;68;3999;52;2015;2172;HOSPITAL GENERAL DE NIÑOS PEDRO DE ELIZALDE;
Cuidados Genereales - Area Indiferenciada;Sector 3 B - Presión Negativa;245;106;351;289;0;289;68;357;4892;3522;134;965;72;987;2664;0;2015;2172;HOSPITAL GENERAL DE NIÑOS PEDRO DE ELIZALDE;
Cuidados Genereales - Area Indiferenciada;Sector 4;773;341;1114;1066;0;1066;50;1116;8440;7165;2312;1963;8489;642;4826;0;2015;2172;HOSPITAL GENERAL DE NIÑOS PEDRO DE ELIZALDE;
Cuidados Genereales - Area Indiferenciada;Sector 5;649;292;941;883;2;885;52;937;8188;6765;2243;1853;8262;722;4177;21;2015;2172;HOSPITAL GENERAL DE NIÑOS PEDRO DE ELIZALDE;
Cuidados Genereales - Area Indiferenciada;Sector 6 A;520;121;641;569;3;572;70;642;4544;2940;1245;805;647;458;5157;47;2015;2172;HOSPITAL GENERAL DE NIÑOS PEDRO DE ELIZALDE;
Cuidados Genereales - Area Indiferenciada;Sector 6 B - Presión Positiva;229;46;275;227;2;229;48;277;3127;1742;857;477;5571;629;3233;72;2015;2172;HOSPITAL GENERAL DE NIÑOS PEDRO DE ELIZALDE;
Cuidados Genereales - Area Indiferenciada;Sector 7;1943;173;2116;1992;1;1993;124;2117;9474;6479;2596;1775;6839;306;8156;5;2015;2172;HOSPITAL GENERAL DE NIÑOS PEDRO DE ELIZALDE;
Cuidados Genereales - Area Indiferenciada;Subtotal Cuidados Genereales - Area Indiferenciada;5865;1741;7606;7045;12;7057;550;7607;58901;45260;16137;124;7684;595;4714;16;2015;2172;HOSPITAL GENERAL DE NIÑOS PEDRO DE ELIZALDE;
Cuidados Especiales;Neonatología Alta Complejidad;96;29;125;18;20;38;88;126;4274;2363;1171;647;5529;1875;1076;1587;2015;2172;HOSPITAL GENERAL DE NIÑOS PEDRO DE ELIZALDE;
Cuidados Especiales;Neonatología Mediana Complejidad;143;82;225;199;1;200;27;227;4204;2486;1152;681;5913;1095;1971;44;2015;2172;HOSPITAL GENERAL DE NIÑOS PEDRO DE ELIZALDE;
Cuidados Especiales;Cuidados Intermedios;91;128;219;80;5;85;134;219;2920;2113;8;579;7236;965;2738;228;2015;2172;HOSPITAL GENERAL DE NIÑOS PEDRO DE ELIZALDE;
Cuidados Especiales;Cuidados Intensivos;115;157;272;11;25;36;237;273;4015;2201;11;603;5482;806;2482;916;2015;2172;HOSPITAL GENERAL DE NIÑOS PEDRO DE ELIZALDE;
Cuidados Especiales;Cirugía Cardiovascular;88;34;122;91;17;108;16;124;3071;1541;841;422;5018;1243;1474;1371;2015;2172;HOSPITAL GENERAL DE NIÑOS PEDRO DE ELIZALDE;
Cuidados Especiales;Guardia;2602;3;2605;1481;0;1481;1123;2604;3029;2832;83;776;935;109;31379;0;2015;2172;HOSPITAL GENERAL DE NIÑOS PEDRO DE ELIZALDE;
Cuidados Especiales;Subtotal Cuidados Especiales;3135;433;3568;1880;68;1948;1625;3573;21513;13536;5894;3708;6292;379;6062;19;2015;2172;HOSPITAL GENERAL DE NIÑOS PEDRO DE ELIZALDE;
Cuidados Especiales;Total Hospital;9035;2176;11211;8962;80;9042;2176;11218;84001;60771;23014;1665;7235;672;3929;88;2015;2172;HOSPITAL GENERAL DE NIÑOS PEDRO DE ELIZALDE;
Medicina;Subtotal Medicina;3031;769;3800;2783;192;2975;796;3771;92416;63134;25319;17297;6832;1674;1489;509;2015;2110;HOSPITAL DE INFECCIOSAS F. MUÑIZ;
Cirugia;Cirugía General;630;114;744;619;12;631;113;744;7376;3761;2021;103;5099;506;3682;161;2015;2110;HOSPITAL DE INFECCIOSAS F. MUÑIZ;
Cirugia;Subtotal Cirugia;630;114;744;619;12;631;113;744;7376;3761;2021;103;5099;506;3682;161;2015;2110;HOSPITAL DE INFECCIOSAS F. MUÑIZ;
Pediatria;Infecciosas Pediatría;454;11;465;457;0;457;10;467;12090;5121;3312;1403;4236;1097;141;0;2015;2110;HOSPITAL DE INFECCIOSAS F. MUÑIZ;
Pediatria;Subtotal Pediatria;454;11;465;457;0;457;10;467;12090;5121;3312;1403;4236;1097;141;0;2015;2110;HOSPITAL DE INFECCIOSAS F. MUÑIZ;
Urgencia;Terapia Intensiva;119;176;295;28;113;141;152;293;3098;2016;849;552;6507;688;3452;3857;2015;2110;HOSPITAL DE INFECCIOSAS F. MUÑIZ;
Urgencia;Observación ;12;23;35;7;10;17;22;39;391;243;107;67;6215;623;3641;2564;2015;2110;HOSPITAL DE INFECCIOSAS F. MUÑIZ;
Urgencia;Subtotal Urgencia;131;199;330;35;123;158;174;332;3489;2259;956;619;6475;68;3473;3705;2015;2110;HOSPITAL DE INFECCIOSAS F. MUÑIZ;
Urgencia;Total Hospital;4246;1093;5339;3894;327;4221;1093;5314;115371;74275;31608;20349;6438;176;1335;775;2015;2110;HOSPITAL DE INFECCIOSAS F. MUÑIZ;
sticas de Salud - MSGC;Fuente : Movimiento Hospitalario;2015;;;;;;;;;;2015;;;;;;2015;2110;HOSPITAL DE INFECCIOSAS F. MUÑIZ;
Medicina;Curieterapia;70;1;71;70;0;70;2;72;1067;205;292;56;1921;285;2463;0;2015;2168;HOSPITAL MUNICIPAL DE ONCOLOGIA MARIE CURIE;
Medicina;Medicina;1645;9;1654;1221;407;1628;21;1649;19235;16966;527;4648;882;1029;3129;2468;2015;2168;HOSPITAL MUNICIPAL DE ONCOLOGIA MARIE CURIE;
Medicina;Subtotal Medicina;1715;10;1725;1291;407;1698;23;1721;20302;17171;5562;4704;8458;998;3094;2365;2015;2168;HOSPITAL MUNICIPAL DE ONCOLOGIA MARIE CURIE;
Cirugia;Cirugía General;767;20;787;759;24;783;7;790;9687;3400;2654;932;351;43;2977;304;2015;2168;HOSPITAL MUNICIPAL DE ONCOLOGIA MARIE CURIE;
Cirugia;Subtotal Cirugia;767;20;787;759;24;783;7;790;9687;3400;2654;932;351;43;2977;304;2015;2168;HOSPITAL MUNICIPAL DE ONCOLOGIA MARIE CURIE;
Cirugia;Total Hospital;2482;30;2512;2050;431;2481;30;2511;29989;20571;8216;5636;686;829;302;1737;2015;2168;HOSPITAL MUNICIPAL DE ONCOLOGIA MARIE CURIE;
sticas de Salud - MSGC;Fuente : Movimiento Hospitalario;2015;;;;;;;;;;2015;;;;;;2015;2168;HOSPITAL MUNICIPAL DE ONCOLOGIA MARIE CURIE;
Cirugia;Cirugía Plástica;517;4;521;519;0;519;2;521;2358;715;646;196;3032;137;8065;0;2015;2112;HOSPITAL DE QUEMADOS DR. ARTURO UMBERTO ILLIA;
Cirugia;Cirugía Plástica Y Reparadora - niÃ±os;47;0;47;46;0;46;1;47;210;67;58;18;319;143;8169;0;2015;2112;HOSPITAL DE QUEMADOS DR. ARTURO UMBERTO ILLIA;
Cirugia;Quemados ;14;134;148;89;2;91;56;147;3677;3071;1007;841;8352;2089;1459;136;2015;2112;HOSPITAL DE QUEMADOS DR. ARTURO UMBERTO ILLIA;
Cirugia;Quemados ;0;16;16;5;0;5;9;14;330;285;9;78;8636;2036;1548;0;2015;2112;HOSPITAL DE QUEMADOS DR. ARTURO UMBERTO ILLIA;
Cirugia;Quemados - Cuidados Generales - Adultos;72;150;222;198;2;200;28;228;5113;3198;1401;876;6255;1403;1628;88;2015;2112;HOSPITAL DE QUEMADOS DR. ARTURO UMBERTO ILLIA;
Cirugia;Subtotal Cirugia;650;304;954;857;4;861;96;957;11688;7336;3202;201;6277;767;2989;42;2015;2112;HOSPITAL DE QUEMADOS DR. ARTURO UMBERTO ILLIA;
Pediatria;Quemados ;56;246;302;128;0;128;171;299;4670;3136;1279;859;6715;1049;2337;0;2015;2112;HOSPITAL DE QUEMADOS DR. ARTURO UMBERTO ILLIA;
Pediatria;Quemados - Cuidados Generales - Pediatría;50;187;237;230;0;230;7;237;2896;2091;793;573;722;882;2987;0;2015;2112;HOSPITAL DE QUEMADOS DR. ARTURO UMBERTO ILLIA;
Pediatria;Quemados - Cuidados Intemedios - Pediatría;10;27;37;21;0;21;19;40;420;273;;;;;;;2015;2112;HOSPITAL DE QUEMADOS DR. ARTURO UMBERTO ILLIA;
Pediatria;Subtotal Pediatria;116;460;576;379;0;379;197;576;7986;5500;2188;1507;6887;955;2633;0;2015;2112;HOSPITAL DE QUEMADOS DR. ARTURO UMBERTO ILLIA;
Urgencia;Guardia;559;1;560;21;2;23;537;560;1095;113;3;31;1032;2;18667;36;2015;2112;HOSPITAL DE QUEMADOS DR. ARTURO UMBERTO ILLIA;
Urgencia;Quemados Cuidados Intensivos - Adultos;0;81;81;2;32;34;47;81;2182;1437;598;394;6586;1774;1355;3951;2015;2112;HOSPITAL DE QUEMADOS DR. ARTURO UMBERTO ILLIA;
Urgencia;Terapia Intensiva;3;66;69;32;1;33;35;68;2194;1312;601;359;598;1929;1131;147;2015;2112;HOSPITAL DE QUEMADOS DR. ARTURO UMBERTO ILLIA;
Urgencia;Subtotal Urgencia;562;148;710;55;35;90;619;709;5471;2862;1499;784;5231;404;473;494;2015;2112;HOSPITAL DE QUEMADOS DR. ARTURO UMBERTO ILLIA;
Internacion De Corta Estadia;Cirugia De Corta Estadia;4;0;4;4;0;4;0;4;4;4;1;1;100;1;365;0;2015;2112;HOSPITAL DE QUEMADOS DR. ARTURO UMBERTO ILLIA;
Internacion De Corta Estadia;Subtotal Internacion De Corta Estadia;4;0;4;4;0;4;0;4;4;4;1;1;100;1;365;0;2015;2112;HOSPITAL DE QUEMADOS DR. ARTURO UMBERTO ILLIA;
Internacion De Corta Estadia;Total Hospital;1332;912;2244;1295;39;1334;912;2246;25149;15702;689;4302;6244;1177;1936;292;2015;2112;HOSPITAL DE QUEMADOS DR. ARTURO UMBERTO ILLIA;
sticas de Salud - MSGC;Fuente : Movimiento Hospitalario;2015;;;;;;;;;;2015;;;;;;2015;2112;HOSPITAL DE QUEMADOS DR. ARTURO UMBERTO ILLIA;
Medicina;Hepatología;10;1;11;5;1;6;7;13;393;379;108;104;9644;2915;1207;769;2015;2109;HOSPITAL DE GASTROENTEROLOGIA B. UDAONDO;
Medicina;Clínica Médica;720;192;912;562;79;641;262;903;13870;12737;38;349;9183;1411;2376;875;2015;2109;HOSPITAL DE GASTROENTEROLOGIA B. UDAONDO;
Medicina;Subtotal Medicina;730;193;923;567;80;647;269;916;14263;13116;3908;3593;9196;1432;2344;873;2015;2109;HOSPITAL DE GASTROENTEROLOGIA B. UDAONDO;
Cirugia;Cirugía;1106;366;1472;1189;17;1206;260;1466;12045;9076;33;2487;7535;619;4442;116;2015;2109;HOSPITAL DE GASTROENTEROLOGIA B. UDAONDO;
Cirugia;Subtotal Cirugia;1106;366;1472;1189;17;1206;260;1466;12045;9076;33;2487;7535;619;4442;116;2015;2109;HOSPITAL DE GASTROENTEROLOGIA B. UDAONDO;
Urgencia;Terapia Intensiva;98;160;258;4;62;66;190;256;2002;1742;548;477;8701;68;4667;2422;2015;2109;HOSPITAL DE GASTROENTEROLOGIA B. UDAONDO;
Urgencia;Subtotal Urgencia;98;160;258;4;62;66;190;256;2002;1742;548;477;8701;68;4667;2422;2015;2109;HOSPITAL DE GASTROENTEROLOGIA B. UDAONDO;
Urgencia;Total Hospital;1934;719;2653;1760;159;1919;719;2638;28310;23934;7756;6557;8454;1247;2474;829;2015;2109;HOSPITAL DE GASTROENTEROLOGIA B. UDAONDO;
sticas de Salud - MSGC;Fuente : Movimiento Hospitalario;2015;;;;;;;;;;2015;;;;;;2015;2109;HOSPITAL DE GASTROENTEROLOGIA B. UDAONDO;
Cirugia;Oftalmología;3033;0;3033;3034;0;3034;0;3034;7300;3753;20;1028;5141;124;1517;0;2015;2169;HOSPITAL OFTALMOLOGICO DR. PEDRO LAGLEYZE;
Cirugia;Subtotal Cirugia;3033;0;3033;3034;0;3034;0;3034;7300;3753;20;1028;5141;124;1517;0;2015;2169;HOSPITAL OFTALMOLOGICO DR. PEDRO LAGLEYZE;
Cirugia;Total Hospital;3033;0;3033;3034;0;3034;0;3034;7300;3753;20;1028;5141;124;1517;0;2015;2169;HOSPITAL OFTALMOLOGICO DR. PEDRO LAGLEYZE;
sticas de Salud - MSGC;Fuente : Movimiento Hospitalario;2015;;;;;;;;;;2015;;;;;;2015;2169;HOSPITAL OFTALMOLOGICO DR. PEDRO LAGLEYZE;
sticas de Salud - MSGC;Fuente : Movimiento Hospitalario;2015;;;;;;;;;;2015;;;;;;2015;2172;HOSPITAL GENERAL DE NIÑOS PEDRO DE ELIZALDE;
Medicina;Pediatria;3030;565;3595;3098;3;3101;495;3596;36042;30561;9875;8373;8479;85;3642;8;2015;2164;HOSPITAL GENERAL DE NIÑOS RICARDO GUTIERREZ;
Medicina;Endocrinología;300;0;300;300;0;300;0;300;2184;300;598;82;1374;1;5014;0;2015;2164;HOSPITAL GENERAL DE NIÑOS RICARDO GUTIERREZ;
Medicina;Infecciosas;498;163;661;500;13;513;156;669;9512;8822;2606;2417;9275;1319;2567;194;2015;2164;HOSPITAL GENERAL DE NIÑOS RICARDO GUTIERREZ;
Medicina;Neonatología;276;36;312;260;13;273;33;306;6638;5889;1819;1613;8872;1925;1683;425;2015;2164;HOSPITAL GENERAL DE NIÑOS RICARDO GUTIERREZ;
Medicina;Centro Respiratorio;337;112;449;345;2;347;103;450;4440;3878;1216;1062;8734;862;3699;44;2015;2164;HOSPITAL GENERAL DE NIÑOS RICARDO GUTIERREZ;
Medicina;Nefrología;311;31;342;312;2;314;25;339;3448;1933;945;53;5606;57;3589;59;2015;2164;HOSPITAL GENERAL DE NIÑOS RICARDO GUTIERREZ;
Medicina;Subtotal Medicina;4752;907;5659;4815;33;4848;812;5660;62264;51383;17059;14078;8252;908;3318;58;2015;2164;HOSPITAL GENERAL DE NIÑOS RICARDO GUTIERREZ;
Cirugia;Cirugía General;1697;220;1917;1685;0;1685;228;1913;9279;6050;2542;1658;652;316;7525;0;2015;2164;HOSPITAL GENERAL DE NIÑOS RICARDO GUTIERREZ;
Cirugia;Cirugía Cardiovascular;269;33;302;252;16;268;37;305;8149;4784;2233;1311;5871;1569;1366;525;2015;2164;HOSPITAL GENERAL DE NIÑOS RICARDO GUTIERREZ;
Cirugia;Cirugía Plástica Y Reparadora - niÃ±os;561;26;587;559;0;559;28;587;3321;1675;91;459;5044;285;6452;0;2015;2164;HOSPITAL GENERAL DE NIÑOS RICARDO GUTIERREZ;
Cirugia;Neurocirugía;368;72;440;357;0;357;86;443;8395;3261;23;893;3884;736;1926;0;2015;2164;HOSPITAL GENERAL DE NIÑOS RICARDO GUTIERREZ;
Cirugia;Ortopedia Y Traumatología;1430;140;1570;1445;0;1445;134;1579;13262;6950;3633;1904;5241;44;4346;0;2015;2164;HOSPITAL GENERAL DE NIÑOS RICARDO GUTIERREZ;
Cirugia;Urologia;296;16;312;294;0;294;18;312;3694;1280;1012;351;3465;41;3083;0;2015;2164;HOSPITAL GENERAL DE NIÑOS RICARDO GUTIERREZ;
Cirugia;Subtotal Cirugia;4621;507;5128;4592;16;4608;531;5139;46100;24000;1263;6575;5206;467;4069;31;2015;2164;HOSPITAL GENERAL DE NIÑOS RICARDO GUTIERREZ;
Urgencia;Terapia Intermedia;36;335;371;9;2;11;357;368;2740;1889;751;518;6894;513;4902;54;2015;2164;HOSPITAL GENERAL DE NIÑOS RICARDO GUTIERREZ;
Urgencia;Terapia Intensiva;103;198;301;7;48;55;247;302;5909;4112;1619;1127;6959;1362;1865;1589;2015;2164;HOSPITAL GENERAL DE NIÑOS RICARDO GUTIERREZ;
Urgencia;Subtotal Urgencia;139;533;672;16;50;66;604;670;8649;6001;237;1644;6938;896;2827;746;2015;2164;HOSPITAL GENERAL DE NIÑOS RICARDO GUTIERREZ;
Urgencia;Total Hospital;9512;1947;11459;9423;99;9522;1947;11469;117013;81384;32058;22297;6955;855;297;104;2015;2164;HOSPITAL GENERAL DE NIÑOS RICARDO GUTIERREZ;
sticas de Salud - MSGC;Fuente : Movimiento Hospitalario;2015;;;;;;;;;;2015;;;;;;2015;2164;HOSPITAL GENERAL DE NIÑOS RICARDO GUTIERREZ;
Pediatria;Recien Nacido Sano;4571;463;5034;4675;0;4675;390;5065;25185;14621;69;4006;5805;289;7341;0;2015;2167;HOSPITAL MATERNO INFANTIL R. SARDA;
Pediatria;Neonatología;1124;937;2061;977;78;1055;1008;2063;29563;16271;8099;4458;5504;789;2547;378;2015;2167;HOSPITAL MATERNO INFANTIL R. SARDA;
Pediatria;Subtotal Pediatria;5695;1400;7095;5652;78;5730;1398;7128;54748;30892;14999;8464;5643;433;4752;109;2015;2167;HOSPITAL MATERNO INFANTIL R. SARDA;
Tocoginecologia;Tocoginecología;6812;144;6956;6906;0;6906;80;6986;35042;27442;9601;7518;7831;393;7277;0;2015;2167;HOSPITAL MATERNO INFANTIL R. SARDA;
Tocoginecologia;Subtotal Tocoginecologia;6812;144;6956;6906;0;6906;80;6986;35042;27442;9601;7518;7831;393;7277;0;2015;2167;HOSPITAL MATERNO INFANTIL R. SARDA;
Urgencia;Terapia Intensiva;72;34;106;7;1;8;100;108;730;370;2;101;5068;343;54;93;2015;2167;HOSPITAL MATERNO INFANTIL R. SARDA;
Urgencia;Subtotal Urgencia;72;34;106;7;1;8;100;108;730;370;2;101;5068;343;54;93;2015;2167;HOSPITAL MATERNO INFANTIL R. SARDA;
Urgencia;Total Hospital;12579;1578;14157;12565;79;12644;1578;14222;90520;58704;248;16083;6485;464;5098;62;2015;2167;HOSPITAL MATERNO INFANTIL R. SARDA;
sticas de Salud - MSGC;Fuente : Movimiento Hospitalario;2015;;;;;;;;;;2015;;;;;;2015;2167;HOSPITAL MATERNO INFANTIL R. SARDA;
Medicina;Dermatología;422;16;438;394;1;395;38;433;12321;7257;3376;1988;589;1676;1283;23;2015;2110;HOSPITAL DE INFECCIOSAS F. MUÑIZ;
Medicina;Infecciosas;1449;268;1717;1381;86;1467;247;1714;43677;31699;11966;8685;7258;1849;1432;502;2015;2110;HOSPITAL DE INFECCIOSAS F. MUÑIZ;
Medicina;Hepatopatía;232;38;270;203;11;214;56;270;4418;1773;121;486;4013;657;2231;407;2015;2110;HOSPITAL DE INFECCIOSAS F. MUÑIZ;
Medicina;Neumotisiología;553;94;647;536;9;545;87;632;22896;16880;6273;4625;7372;2671;1008;142;2015;2110;HOSPITAL DE INFECCIOSAS F. MUÑIZ;
Medicina;Asistencia Respiratoria Intermedia;190;296;486;85;84;169;310;479;4363;3057;1195;838;7007;638;4007;1754;2015;2110;HOSPITAL DE INFECCIOSAS F. MUÑIZ;
Medicina;Zoopatología Médica;185;57;242;184;1;185;58;243;4741;2468;1299;676;5206;1016;1871;41;2015;2110;HOSPITAL DE INFECCIOSAS F. MUÑIZ;
Urgencia;Total Hospital;13961;1917;15878;13593;388;13981;1917;15898;112236;89430;3075;24501;7968;64;4547;278;2015;2161;HOSPITAL GENERAL DE AGUDOS J. A. PENNA;
sticas de Salud - MSGC;Fuente : Movimiento Hospitalario;2015;;;;;;;;;;2015;;;;;;2015;2161;HOSPITAL GENERAL DE AGUDOS J. A. PENNA;
Medicina;Psicopatologia Y Salud Mental;59;63;122;123;0;123;3;126;7309;5613;2002;1538;768;4455;629;0;2015;2163;HOSPITAL GENERAL DE AGUDOS P. PIÑERO;
Medicina;Subtotal Medicina;59;63;122;123;0;123;3;126;7309;5613;2002;1538;768;4455;629;0;2015;2163;HOSPITAL GENERAL DE AGUDOS P. PIÑERO;
Cirugia;Ginecología;391;26;417;385;4;389;27;416;2916;1494;799;409;5123;359;5207;96;2015;2163;HOSPITAL GENERAL DE AGUDOS P. PIÑERO;
Cirugia;Subtotal Cirugia;391;26;417;385;4;389;27;416;2916;1494;799;409;5123;359;5207;96;2015;2163;HOSPITAL GENERAL DE AGUDOS P. PIÑERO;
Pediatria;Recien Nacido Sano;2352;0;2352;1963;0;1963;399;2362;8877;6330;2432;1734;7131;268;9712;0;2015;2163;HOSPITAL GENERAL DE AGUDOS P. PIÑERO;
Pediatria;Neonatología;91;399;490;484;10;494;1;495;8030;4829;22;1323;6014;976;225;202;2015;2163;HOSPITAL GENERAL DE AGUDOS P. PIÑERO;
Pediatria;Pediatría;892;8;900;891;3;894;0;894;8021;4219;2198;1156;526;472;4068;34;2015;2163;HOSPITAL GENERAL DE AGUDOS P. PIÑERO;
Pediatria;Subtotal Pediatria;3335;407;3742;3338;13;3351;400;3751;24928;15378;683;4213;6169;41;5492;35;2015;2163;HOSPITAL GENERAL DE AGUDOS P. PIÑERO;
Tocoginecologia;Obstetricia;3040;49;3089;3040;0;3040;53;3093;16072;11228;4403;3076;6986;363;7024;0;2015;2163;HOSPITAL GENERAL DE AGUDOS P. PIÑERO;
Tocoginecologia;Subtotal Tocoginecologia;3040;49;3089;3040;0;3040;53;3093;16072;11228;4403;3076;6986;363;7024;0;2015;2163;HOSPITAL GENERAL DE AGUDOS P. PIÑERO;
Urgencia;Guardia Del Día;2968;42;3010;948;202;1150;1860;3010;4264;4201;1168;1151;9852;14;25766;671;2015;2163;HOSPITAL GENERAL DE AGUDOS P. PIÑERO;
Urgencia;Terapia Intensiva;23;383;406;58;106;164;238;402;3239;2892;887;792;8929;719;453;2637;2015;2163;HOSPITAL GENERAL DE AGUDOS P. PIÑERO;
Urgencia;Subtotal Urgencia;2991;425;3416;1006;308;1314;2098;3412;7503;7093;2056;1943;9454;208;16598;903;2015;2163;HOSPITAL GENERAL DE AGUDOS P. PIÑERO;
Area Indiferenciada;Area Indiferenciada;924;1892;2816;2379;183;2562;281;2843;50983;37257;13968;10207;7308;131;2035;644;2015;2163;HOSPITAL GENERAL DE AGUDOS P. PIÑERO;
Area Indiferenciada;Subtotal Area Indiferenciada;924;1892;2816;2379;183;2562;281;2843;50983;37257;13968;10207;7308;131;2035;644;2015;2163;HOSPITAL GENERAL DE AGUDOS P. PIÑERO;
Area Indiferenciada;Total Hospital;10740;2862;13602;10271;508;10779;2862;13641;109711;78063;30058;21387;7115;724;3586;471;2015;2163;HOSPITAL GENERAL DE AGUDOS P. PIÑERO;
sticas de Salud - MSGC;Fuente : Movimiento Hospitalario;2015;;;;;;;;;;2015;;;;;;2015;2163;HOSPITAL GENERAL DE AGUDOS P. PIÑERO;
Medicina;Cardiología;0;63;63;52;0;52;11;63;1166;233;319;64;1998;37;1972;0;2015;2125;HOSPITAL GENERAL DE AGUDOS DR. I. PIROVANO;
Medicina;Clínica Médica;967;317;1284;892;251;1143;137;1280;24716;21686;6772;5941;8774;1694;189;1961;2015;2125;HOSPITAL GENERAL DE AGUDOS DR. I. PIROVANO;
Medicina;Unidad Coronaria;222;31;253;155;20;175;78;253;2410;1710;66;468;7095;676;3832;791;2015;2125;HOSPITAL GENERAL DE AGUDOS DR. I. PIROVANO;
Medicina;Subtotal Medicina;1189;411;1600;1099;271;1370;226;1596;28292;23629;7751;6474;8352;1481;2059;1698;2015;2125;HOSPITAL GENERAL DE AGUDOS DR. I. PIROVANO;
Cirugia;Cirugía General;1201;114;1315;1167;44;1211;103;1314;19344;13606;53;3728;7034;1035;2479;335;2015;2125;HOSPITAL GENERAL DE AGUDOS DR. I. PIROVANO;
Cirugia;Ginecología;723;65;788;635;12;647;146;793;6163;5616;1688;1539;9112;708;4696;151;2015;2125;HOSPITAL GENERAL DE AGUDOS DR. I. PIROVANO;
Cirugia;Neurocirugía;178;92;270;178;6;184;85;269;5750;3987;1575;1092;6934;1482;1708;223;2015;2125;HOSPITAL GENERAL DE AGUDOS DR. I. PIROVANO;
Cirugia;Oftalmología;274;6;280;257;0;257;22;279;2523;1078;691;295;4273;386;4036;0;2015;2125;HOSPITAL GENERAL DE AGUDOS DR. I. PIROVANO;
Cirugia;Ortopedia Y Traumatología;543;63;606;480;24;504;112;616;16861;13278;4619;3638;7875;2156;1333;39;2015;2125;HOSPITAL GENERAL DE AGUDOS DR. I. PIROVANO;
Cirugia;Otorrinolaringología;218;12;230;192;2;194;36;230;2755;1414;755;387;5132;615;3047;87;2015;2125;HOSPITAL GENERAL DE AGUDOS DR. I. PIROVANO;
Cirugia;Urología;353;69;422;392;10;402;22;424;4202;2692;1151;738;6406;635;3683;236;2015;2125;HOSPITAL GENERAL DE AGUDOS DR. I. PIROVANO;
Cirugia;Subtotal Cirugia;3490;421;3911;3301;98;3399;526;3925;57598;41671;1578;11417;7235;1062;2487;25;2015;2125;HOSPITAL GENERAL DE AGUDOS DR. I. PIROVANO;
Pediatria;Recien Nacido Sano;884;0;884;772;0;772;109;881;11315;2502;31;685;2211;284;2842;0;2015;2125;HOSPITAL GENERAL DE AGUDOS DR. I. PIROVANO;
Pediatria;Neonatología;235;109;344;346;3;349;0;349;3393;2425;93;664;7147;695;3754;86;2015;2125;HOSPITAL GENERAL DE AGUDOS DR. I. PIROVANO;
Pediatria;Pediatría;949;0;949;948;0;948;0;948;9490;3056;26;837;322;322;3646;0;2015;2125;HOSPITAL GENERAL DE AGUDOS DR. I. PIROVANO;
Pediatria;Subtotal Pediatria;2068;109;2177;2066;3;2069;109;2178;24198;7983;663;2187;3299;367;3285;14;2015;2125;HOSPITAL GENERAL DE AGUDOS DR. I. PIROVANO;
Tocoginecologia;Obstetricia;1699;10;1709;1632;0;1632;71;1703;11146;5836;3054;1599;5236;343;5577;0;2015;2125;HOSPITAL GENERAL DE AGUDOS DR. I. PIROVANO;
Tocoginecologia;Subtotal Tocoginecologia;1699;10;1709;1632;0;1632;71;1703;11146;5836;3054;1599;5236;343;5577;0;2015;2125;HOSPITAL GENERAL DE AGUDOS DR. I. PIROVANO;
Urgencia;Terapia Intermedia;11;105;116;5;4;9;108;117;1458;1239;399;339;8498;1059;2929;342;2015;2125;HOSPITAL GENERAL DE AGUDOS DR. I. PIROVANO;
Urgencia;Terapia Intensiva;91;201;292;3;69;72;217;289;3011;2917;825;799;9688;1009;3503;2388;2015;2125;HOSPITAL GENERAL DE AGUDOS DR. I. PIROVANO;
Urgencia;Subtotal Urgencia;102;306;408;8;73;81;325;406;4469;4156;1224;1139;93;1024;3316;1798;2015;2125;HOSPITAL GENERAL DE AGUDOS DR. I. PIROVANO;
Urgencia;Total Hospital;8548;1257;9805;8106;445;8551;1257;9808;125703;83275;34439;22815;6625;974;2483;52;2015;2125;HOSPITAL GENERAL DE AGUDOS DR. I. PIROVANO;
sticas de Salud - MSGC;Fuente : Movimiento Hospitalario;2015;;;;;;;;;;2015;;;;;;2015;2125;HOSPITAL GENERAL DE AGUDOS DR. I. PIROVANO;
Medicina;Cardiología;213;286;499;401;3;404;95;499;6804;3334;1864;913;49;668;2677;6;2015;2162;HOSPITAL GENERAL DE AGUDOS J. M. RAMOS MEJIA;
Medicina;Clínica Médica;611;1067;1678;1300;140;1440;241;1681;36432;32221;9981;8828;8844;1917;1684;833;2015;2162;HOSPITAL GENERAL DE AGUDOS J. M. RAMOS MEJIA;
Medicina;Dermatología;110;27;137;118;0;118;19;137;3618;2651;991;726;7327;1935;1382;0;2015;2162;HOSPITAL GENERAL DE AGUDOS J. M. RAMOS MEJIA;
Medicina;Hematología;107;34;141;115;8;123;15;138;3618;2378;991;652;6573;1723;1392;58;2015;2162;HOSPITAL GENERAL DE AGUDOS J. M. RAMOS MEJIA;
Medicina;Neurología;482;111;593;554;4;558;34;592;5416;3532;1484;968;6521;597;399;68;2015;2162;HOSPITAL GENERAL DE AGUDOS J. M. RAMOS MEJIA;
Medicina;Tisiología;82;56;138;109;4;113;26;139;5054;2978;1385;816;5892;2142;1004;288;2015;2162;HOSPITAL GENERAL DE AGUDOS J. M. RAMOS MEJIA;
Medicina;Unidad Coronaria;313;159;472;141;45;186;288;474;2528;2083;693;571;824;439;6844;949;2015;2162;HOSPITAL GENERAL DE AGUDOS J. M. RAMOS MEJIA;
Medicina;Subtotal Medicina;1918;1740;3658;2738;204;2942;718;3660;63470;49177;17389;13473;7748;1344;2105;557;2015;2162;HOSPITAL GENERAL DE AGUDOS J. M. RAMOS MEJIA;
Cirugia;Cirugía General;1067;381;1448;1294;11;1305;138;1443;22259;13926;6098;3815;6256;965;2366;76;2015;2162;HOSPITAL GENERAL DE AGUDOS J. M. RAMOS MEJIA;
Cirugia;Cirugía Plástica Y Reparadora - niÃ±os;356;11;367;360;0;360;7;367;5054;1050;1385;288;2078;286;265;0;2015;2162;HOSPITAL GENERAL DE AGUDOS J. M. RAMOS MEJIA;
Cirugia;Ginecología;317;26;343;323;3;326;17;343;4954;2207;1357;605;4455;643;2527;87;2015;2162;HOSPITAL GENERAL DE AGUDOS J. M. RAMOS MEJIA;
Cirugia;Neurocirugía;99;77;176;126;0;126;50;176;1408;848;386;232;6023;482;4563;0;2015;2162;HOSPITAL GENERAL DE AGUDOS J. M. RAMOS MEJIA;
Cirugia;Oftalmología;6;0;6;6;0;6;0;6;129;6;35;2;465;1;1698;0;2015;2162;HOSPITAL GENERAL DE AGUDOS J. M. RAMOS MEJIA;
Cirugia;Ortopedia Y Traumatología;243;62;305;265;3;268;36;304;10171;6179;2787;1693;6075;2033;1091;99;2015;2162;HOSPITAL GENERAL DE AGUDOS J. M. RAMOS MEJIA;
Cirugia;Otorrinolaringología;76;2;78;76;0;76;2;78;387;89;106;24;23;114;7357;0;2015;2162;HOSPITAL GENERAL DE AGUDOS J. M. RAMOS MEJIA;
Cirugia;Urología;164;107;271;245;1;246;31;277;6687;3817;1832;1046;5708;1378;1512;36;2015;2162;HOSPITAL GENERAL DE AGUDOS J. M. RAMOS MEJIA;
Cirugia;Subtotal Cirugia;2328;666;2994;2695;18;2713;281;2994;51049;28122;13986;7705;5509;939;2141;6;2015;2162;HOSPITAL GENERAL DE AGUDOS J. M. RAMOS MEJIA;
Pediatria;Recien Nacido Sano;1336;1;1337;1269;0;1269;68;1337;5983;3947;1639;1081;6597;295;8157;0;2015;2162;HOSPITAL GENERAL DE AGUDOS J. M. RAMOS MEJIA;
Pediatria;Neonatología;172;68;240;232;7;239;1;240;4619;2785;1265;763;6029;116;1897;292;2015;2162;HOSPITAL GENERAL DE AGUDOS J. M. RAMOS MEJIA;
Pediatria;Pediatría;539;6;545;538;1;539;0;539;8154;2189;2234;6;2685;406;2413;19;2015;2162;HOSPITAL GENERAL DE AGUDOS J. M. RAMOS MEJIA;
Pediatria;Subtotal Pediatria;2047;75;2122;2039;8;2047;69;2116;18756;8921;5139;2444;4756;422;4118;38;2015;2162;HOSPITAL GENERAL DE AGUDOS J. M. RAMOS MEJIA;
Tocoginecologia;Obstetricia;1890;14;1904;1892;0;1892;16;1908;8813;7255;2415;1988;8232;38;7902;0;2015;2162;HOSPITAL GENERAL DE AGUDOS J. M. RAMOS MEJIA;
Tocoginecologia;Subtotal Tocoginecologia;1890;14;1904;1892;0;1892;16;1908;8813;7255;2415;1988;8232;38;7902;0;2015;2162;HOSPITAL GENERAL DE AGUDOS J. M. RAMOS MEJIA;
Urgencia;Guardia Del Día;2555;150;2705;708;371;1079;1626;2705;4394;5385;1204;1475;12255;199;2247;1372;2015;2162;HOSPITAL GENERAL DE AGUDOS J. M. RAMOS MEJIA;
Urgencia;Terapia Intensiva;12;296;308;6;67;73;231;304;3996;3542;1095;97;8864;1165;2777;2204;2015;2162;HOSPITAL GENERAL DE AGUDOS J. M. RAMOS MEJIA;
Urgencia;Subtotal Urgencia;2567;446;3013;714;438;1152;1857;3009;8390;8927;2299;2446;1064;297;1309;1456;2015;2162;HOSPITAL GENERAL DE AGUDOS J. M. RAMOS MEJIA;
Urgencia;Total Hospital;10750;2941;13691;10078;668;10746;2941;13687;150478;102402;41227;28055;6805;953;2607;622;2015;2162;HOSPITAL GENERAL DE AGUDOS J. M. RAMOS MEJIA;
sticas de Salud - MSGC;Fuente : Movimiento Hospitalario;2015;;;;;;;;;;2015;;;;;;2015;2162;HOSPITAL GENERAL DE AGUDOS J. M. RAMOS MEJIA;
Medicina;Cardiología;121;210;331;276;1;277;52;329;4376;1521;1199;417;3476;462;2744;3;2015;2119;HOSPITAL GENERAL DE AGUDOS B. RIVADAVIA;
Medicina;Clínica Médica;797;84;881;703;95;798;74;872;19575;12987;5363;3558;6634;1489;1626;1089;2015;2119;HOSPITAL GENERAL DE AGUDOS B. RIVADAVIA;
Medicina;Nutrición;75;4;79;73;0;73;6;79;3621;659;992;181;182;834;796;0;2015;2119;HOSPITAL GENERAL DE AGUDOS B. RIVADAVIA;
Medicina;Curieterapia;22;0;22;22;0;22;0;22;2408;66;66;18;274;3;333;0;2015;2119;HOSPITAL GENERAL DE AGUDOS B. RIVADAVIA;
Medicina;Unidad Coronaria;209;100;309;52;16;68;239;307;2203;1358;604;372;6164;442;5086;521;2015;2119;HOSPITAL GENERAL DE AGUDOS B. RIVADAVIA;
Medicina;Subtotal Medicina;1224;398;1622;1126;112;1238;371;1609;32183;16591;8817;4545;5155;1031;1825;696;2015;2119;HOSPITAL GENERAL DE AGUDOS B. RIVADAVIA;
Cirugia;Cirugía General;719;45;764;691;9;700;64;764;13106;3548;3591;972;2707;464;2128;118;2015;2119;HOSPITAL GENERAL DE AGUDOS B. RIVADAVIA;
Cirugia;Cirugía Cardiovascular;49;17;66;55;0;55;11;66;1785;286;489;78;1602;433;135;0;2015;2119;HOSPITAL GENERAL DE AGUDOS B. RIVADAVIA;
Cirugia;Ginecología;456;9;465;455;2;457;8;465;5536;1752;1517;48;3165;377;3066;43;2015;2119;HOSPITAL GENERAL DE AGUDOS B. RIVADAVIA;
Cirugia;Neurocirugía;154;28;182;159;0;159;23;182;2398;1062;657;291;4429;584;277;0;2015;2119;HOSPITAL GENERAL DE AGUDOS B. RIVADAVIA;
Cirugia;Ortopedia Y Traumatología;309;17;326;302;4;306;18;324;4860;2902;1332;795;5971;896;2433;123;2015;2119;HOSPITAL GENERAL DE AGUDOS B. RIVADAVIA;
Cirugia;Otorrinolaringología;186;3;189;188;0;188;1;189;2655;441;727;121;1661;233;2598;0;2015;2119;HOSPITAL GENERAL DE AGUDOS B. RIVADAVIA;
Cirugia;Urología;298;14;312;297;1;298;14;312;4376;1388;1199;38;3172;445;2602;32;2015;2119;HOSPITAL GENERAL DE AGUDOS B. RIVADAVIA;
Cirugia;Subtotal Cirugia;2171;133;2304;2147;16;2163;139;2302;34716;11379;9511;3118;3278;494;242;7;2015;2119;HOSPITAL GENERAL DE AGUDOS B. RIVADAVIA;
Pediatria;Recien Nacido Sano;828;197;1025;976;0;976;50;1026;3672;3672;1006;1006;100;358;10199;0;2015;2119;HOSPITAL GENERAL DE AGUDOS B. RIVADAVIA;
Pediatria;Neonatología;325;50;375;162;9;171;202;373;7272;4468;1992;1224;6144;1198;1872;241;2015;2119;HOSPITAL GENERAL DE AGUDOS B. RIVADAVIA;
Pediatria;Pediatría;701;5;706;703;1;704;1;705;5441;2594;1491;711;4768;368;4729;14;2015;2119;HOSPITAL GENERAL DE AGUDOS B. RIVADAVIA;
Pediatria;Subtotal Pediatria;1854;252;2106;1841;10;1851;253;2104;16385;10734;4489;2941;6551;51;4687;48;2015;2119;HOSPITAL GENERAL DE AGUDOS B. RIVADAVIA;
Tocoginecologia;Obstetricia;1441;6;1447;1440;0;1440;5;1445;10277;8468;2816;232;824;586;5132;0;2015;2119;HOSPITAL GENERAL DE AGUDOS B. RIVADAVIA;
Tocoginecologia;Subtotal Tocoginecologia;1441;6;1447;1440;0;1440;5;1445;10277;8468;2816;232;824;586;5132;0;2015;2119;HOSPITAL GENERAL DE AGUDOS B. RIVADAVIA;
Urgencia;Coordinacion Cuidados Intensivos;93;118;211;6;64;70;139;209;3018;2365;827;648;7836;1132;2528;3062;2015;2119;HOSPITAL GENERAL DE AGUDOS B. RIVADAVIA;
Urgencia;Subtotal Urgencia;93;118;211;6;64;70;139;209;3018;2365;827;648;7836;1132;2528;3062;2015;2119;HOSPITAL GENERAL DE AGUDOS B. RIVADAVIA;
Urgencia;Total Hospital;6783;907;7690;6560;202;6762;907;7669;96579;49537;2646;13572;5129;733;2556;299;2015;2119;HOSPITAL GENERAL DE AGUDOS B. RIVADAVIA;
sticas de Salud - MSGC;Fuente : Movimiento Hospitalario;2015;;;;;;;;;;2015;;;;;;2015;2119;HOSPITAL GENERAL DE AGUDOS B. RIVADAVIA;
Medicina;Cardiología;211;215;426;343;7;350;73;423;4380;1957;12;536;4468;463;3525;165;2015;2121;HOSPITAL GENERAL DE AGUDOS DONACION F. SANTOJANNI;
Medicina;Clínica Médica;811;184;995;685;173;858;120;978;24212;22495;6633;6163;9291;23;1474;1769;2015;2121;HOSPITAL GENERAL DE AGUDOS DONACION F. SANTOJANNI;
Medicina;Unidad Coronaria;403;129;532;205;43;248;282;530;2921;1994;8;546;6826;376;6623;811;2015;2121;HOSPITAL GENERAL DE AGUDOS DONACION F. SANTOJANNI;
Medicina;Subtotal Medicina;1425;528;1953;1233;223;1456;475;1931;31513;26446;8634;7245;8392;137;2237;1155;2015;2121;HOSPITAL GENERAL DE AGUDOS DONACION F. SANTOJANNI;
Cirugia;Cirugía General;848;109;957;876;17;893;63;956;10311;6398;2825;1753;6205;669;3384;178;2015;2121;HOSPITAL GENERAL DE AGUDOS DONACION F. SANTOJANNI;
Cirugia;Cirugía Cardiovascular;42;0;42;42;0;42;3;45;668;42;183;12;629;93;2459;0;2015;2121;HOSPITAL GENERAL DE AGUDOS DONACION F. SANTOJANNI;
Cirugia;Microcirugia Y Cirugia Reparadora;346;2;348;348;0;348;0;348;1828;433;501;119;2369;124;6949;0;2015;2121;HOSPITAL GENERAL DE AGUDOS DONACION F. SANTOJANNI;
Cirugia;Ginecología;400;32;432;412;3;415;19;434;4661;2945;1277;807;6318;679;3399;69;2015;2121;HOSPITAL GENERAL DE AGUDOS DONACION F. SANTOJANNI;
Cirugia;Neurocirugía;133;53;186;155;3;158;26;184;4231;3219;1159;882;7608;1749;1587;163;2015;2121;HOSPITAL GENERAL DE AGUDOS DONACION F. SANTOJANNI;
Cirugia;Ortopedia Y Traumatología;314;36;350;317;11;328;15;343;8910;6608;2441;181;7416;1927;1405;321;2015;2121;HOSPITAL GENERAL DE AGUDOS DONACION F. SANTOJANNI;
Cirugia;Otorrinolaringología;9;2;11;9;0;9;0;9;10;9;3;2;90;1;3285;0;2015;2121;HOSPITAL GENERAL DE AGUDOS DONACION F. SANTOJANNI;
Cirugia;Urología;205;9;214;208;1;209;8;217;1849;751;507;206;4062;346;4284;46;2015;2121;HOSPITAL GENERAL DE AGUDOS DONACION F. SANTOJANNI;
Cirugia;Subtotal Cirugia;2297;243;2540;2367;35;2402;134;2536;32468;20405;8895;559;6285;805;2851;138;2015;2121;HOSPITAL GENERAL DE AGUDOS DONACION F. SANTOJANNI;
Pediatria;Recien Nacido Sano;2704;214;2918;2861;0;2861;77;2938;21894;12676;5998;3473;579;431;4898;0;2015;2121;HOSPITAL GENERAL DE AGUDOS DONACION F. SANTOJANNI;
Pediatria;Neonatología;393;223;616;231;18;249;373;622;10282;5879;2817;1611;5718;945;2208;289;2015;2121;HOSPITAL GENERAL DE AGUDOS DONACION F. SANTOJANNI;
Pediatria;Pediatría;988;3;991;987;0;987;1;988;10115;5014;2771;1374;4957;507;3565;0;2015;2121;HOSPITAL GENERAL DE AGUDOS DONACION F. SANTOJANNI;
Pediatria;Subtotal Pediatria;4085;440;4525;4079;18;4097;451;4548;42291;23569;11587;6457;5573;518;3925;4;2015;2121;HOSPITAL GENERAL DE AGUDOS DONACION F. SANTOJANNI;
Tocoginecologia;Obstetricia;3271;5;3276;3293;0;3293;5;3298;21894;18366;5998;5032;8389;557;5498;0;2015;2121;HOSPITAL GENERAL DE AGUDOS DONACION F. SANTOJANNI;
Tocoginecologia;Subtotal Tocoginecologia;3271;5;3276;3293;0;3293;5;3298;21894;18366;5998;5032;8389;557;5498;0;2015;2121;HOSPITAL GENERAL DE AGUDOS DONACION F. SANTOJANNI;
Urgencia;Terapia Intermedia;10;24;34;3;3;6;26;32;2696;607;739;166;2251;1897;433;938;2015;2121;HOSPITAL GENERAL DE AGUDOS DONACION F. SANTOJANNI;
Urgencia;Terapia Intensiva;87;140;227;8;72;80;149;229;4380;3241;12;888;74;1415;1908;3144;2015;2121;HOSPITAL GENERAL DE AGUDOS DONACION F. SANTOJANNI;
Urgencia;Observación ;397;33;430;71;189;260;173;433;2924;2007;801;55;6864;464;5405;4365;2015;2121;HOSPITAL GENERAL DE AGUDOS DONACION F. SANTOJANNI;
Urgencia;Subtotal Urgencia;494;197;691;82;264;346;348;694;10000;5855;274;1604;5855;844;2533;3804;2015;2121;HOSPITAL GENERAL DE AGUDOS DONACION F. SANTOJANNI;
Urgencia;Total Hospital;11572;1413;12985;11054;540;11594;1413;13007;138166;94641;37854;25929;685;816;3063;466;2015;2121;HOSPITAL GENERAL DE AGUDOS DONACION F. SANTOJANNI;
sticas de Salud - MSGC;Fuente : Movimiento Hospitalario;2015;;;;;;;;;;2015;;;;;;2015;2121;HOSPITAL GENERAL DE AGUDOS DONACION F. SANTOJANNI;
Medicina;Cuidados Paliativos;83;40;123;54;68;122;1;123;1462;1323;401;362;9049;1076;3071;5528;2015;2124;HOSPITAL GENERAL DE AGUDOS DR. E. TORNU;
Medicina;Clínica Médica;123;911;1034;761;129;890;143;1033;17980;16309;4926;4468;9071;1579;2097;1249;2015;2124;HOSPITAL GENERAL DE AGUDOS DR. E. TORNU;
Medicina;Neumotisiología;100;399;499;369;30;399;99;498;15078;5281;4131;1447;3502;106;1206;602;2015;2124;HOSPITAL GENERAL DE AGUDOS DR. E. TORNU;
Medicina;Subtotal Medicina;306;1350;1656;1184;227;1411;243;1654;34520;22913;9458;6278;6638;1385;1749;1372;2015;2124;HOSPITAL GENERAL DE AGUDOS DR. E. TORNU;
Cirugia;Cirugía General;474;393;867;805;3;808;63;871;8905;4740;244;1299;5323;544;357;34;2015;2124;HOSPITAL GENERAL DE AGUDOS DR. E. TORNU;
Cirugia;Cirugía Toracica;72;51;123;89;1;90;32;122;2059;556;564;152;27;456;2163;82;2015;2124;HOSPITAL GENERAL DE AGUDOS DR. E. TORNU;
Cirugia;Ginecología;181;4;185;182;1;183;3;186;481;481;132;132;100;259;14114;54;2015;2124;HOSPITAL GENERAL DE AGUDOS DR. E. TORNU;
Cirugia;Ortopedia Y Traumatología;30;106;136;117;2;119;22;141;4557;3418;1248;936;7501;2424;1129;142;2015;2124;HOSPITAL GENERAL DE AGUDOS DR. E. TORNU;
Cirugia;Urología;174;39;213;191;0;191;22;213;788;789;216;216;10013;37;9866;0;2015;2124;HOSPITAL GENERAL DE AGUDOS DR. E. TORNU;
Cirugia;Subtotal Cirugia;931;593;1524;1384;7;1391;142;1533;16790;9984;46;2735;5946;651;3333;46;2015;2124;HOSPITAL GENERAL DE AGUDOS DR. E. TORNU;
Urgencia;Terapia Intermedia;10;228;238;93;36;129;107;236;4176;2748;1144;753;658;1164;2063;1525;2015;2124;HOSPITAL GENERAL DE AGUDOS DR. E. TORNU;
Urgencia;Guardia Del Día;3163;48;3211;1312;79;1391;1819;3210;2220;2401;608;658;10815;75;52777;246;2015;2124;HOSPITAL GENERAL DE AGUDOS DR. E. TORNU;
Urgencia;Terapia Intensiva;11;247;258;26;77;103;155;258;3794;2703;1039;741;7124;1048;2482;2984;2015;2124;HOSPITAL GENERAL DE AGUDOS DR. E. TORNU;
Urgencia;Subtotal Urgencia;3184;523;3707;1431;192;1623;2081;3704;10190;7852;2792;2151;7706;212;13268;518;2015;2124;HOSPITAL GENERAL DE AGUDOS DR. E. TORNU;
Urgencia;Total Hospital;4421;2466;6887;3999;426;4425;2466;6891;61500;40749;16849;11164;6626;921;2626;963;2015;2124;HOSPITAL GENERAL DE AGUDOS DR. E. TORNU;
sticas de Salud - MSGC;Fuente : Movimiento Hospitalario;2015;;;;;;;;;;2015;;;;;;2015;2124;HOSPITAL GENERAL DE AGUDOS DR. E. TORNU;
Medicina;Cardiología;43;32;75;67;3;70;7;77;834;588;228;161;705;764;337;39;2015;2120;HOSPITAL GENERAL DE AGUDOS D. VELEZ SARSFIELD;
Pediatria;Recien Nacido Sano;2113;0;2113;1745;0;1745;375;2120;8816;5637;2409;154;6394;266;8801;0;2016;2163;HOSPITAL GENERAL DE AGUDOS P. PIÑERO;
Pediatria;Neonatología;88;375;463;450;13;463;3;466;8052;4494;22;1228;5581;964;2118;279;2016;2163;HOSPITAL GENERAL DE AGUDOS P. PIÑERO;
Pediatria;Pediatría;771;9;780;786;1;787;2;789;8053;3658;22;999;4542;464;3586;13;2016;2163;HOSPITAL GENERAL DE AGUDOS P. PIÑERO;
Pediatria;Subtotal Pediatria;2972;384;3356;2981;14;2995;380;3375;24921;13789;6809;3767;5533;409;4957;41;2016;2163;HOSPITAL GENERAL DE AGUDOS P. PIÑERO;
Tocoginecologia;Obstetricia;2866;50;2916;2865;0;2865;60;2925;16111;11081;4402;3028;6878;379;6645;0;2016;2163;HOSPITAL GENERAL DE AGUDOS P. PIÑERO;
Tocoginecologia;Subtotal Tocoginecologia;2866;50;2916;2865;0;2865;60;2925;16111;11081;4402;3028;6878;379;6645;0;2016;2163;HOSPITAL GENERAL DE AGUDOS P. PIÑERO;
Urgencia;Guardia Del Día;2943;70;3013;920;235;1155;1858;3013;4468;4409;1221;1205;9868;146;24681;78;2016;2163;HOSPITAL GENERAL DE AGUDOS P. PIÑERO;
Urgencia;Terapia Intensiva;28;536;564;68;109;177;384;561;4358;3861;1191;1055;886;688;4711;1943;2016;2163;HOSPITAL GENERAL DE AGUDOS P. PIÑERO;
Urgencia;Subtotal Urgencia;2971;606;3577;988;344;1332;2242;3574;8826;8270;2411;226;937;231;14821;963;2016;2163;HOSPITAL GENERAL DE AGUDOS P. PIÑERO;
Area Indiferenciada;Area Indiferenciada;813;1938;2751;2197;185;2382;366;2748;48818;33523;13338;9159;6867;122;206;673;2016;2163;HOSPITAL GENERAL DE AGUDOS P. PIÑERO;
Area Indiferenciada;Subtotal Area Indiferenciada;813;1938;2751;2197;185;2382;366;2748;48818;33523;13338;9159;6867;122;206;673;2016;2163;HOSPITAL GENERAL DE AGUDOS P. PIÑERO;
Area Indiferenciada;Total Hospital;10070;3080;13150;9549;545;10094;3080;13174;108935;73335;29764;20037;6732;727;3391;54;2016;2163;HOSPITAL GENERAL DE AGUDOS P. PIÑERO;
Medicina;Cardiología;46;25;71;65;0;65;6;71;2196;153;6;42;697;215;1183;0;2016;2125;HOSPITAL GENERAL DE AGUDOS DR. I. PIROVANO;
Medicina;Clínica Médica;980;381;1361;905;239;1144;203;1347;27327;24965;7466;6821;9136;1853;1804;1774;2016;2125;HOSPITAL GENERAL DE AGUDOS DR. I. PIROVANO;
Medicina;Unidad Coronaria;212;24;236;177;18;195;41;236;2928;2066;8;564;7056;875;295;763;2016;2125;HOSPITAL GENERAL DE AGUDOS DR. I. PIROVANO;
Medicina;Subtotal Medicina;1238;430;1668;1147;257;1404;250;1654;32451;27184;8866;7427;8377;1644;1865;1554;2016;2125;HOSPITAL GENERAL DE AGUDOS DR. I. PIROVANO;
Cirugia;Cirugía General;1132;166;1298;1113;48;1161;124;1285;17414;12777;4758;3491;7337;994;2701;374;2016;2125;HOSPITAL GENERAL DE AGUDOS DR. I. PIROVANO;
Cirugia;Ginecología;621;93;714;567;7;574;138;712;5562;4802;152;1312;8634;674;4685;98;2016;2125;HOSPITAL GENERAL DE AGUDOS DR. I. PIROVANO;
Cirugia;Neurocirugía;174;78;252;173;4;177;73;250;4709;3223;1287;881;6844;1289;1943;16;2016;2125;HOSPITAL GENERAL DE AGUDOS DR. I. PIROVANO;
Cirugia;Oftalmología;246;10;256;227;3;230;27;257;2257;1033;617;282;4577;402;4168;117;2016;2125;HOSPITAL GENERAL DE AGUDOS DR. I. PIROVANO;
Cirugia;Ortopedia Y Traumatología;557;86;643;447;18;465;169;634;16582;12380;4531;3383;7466;1953;1399;284;2016;2125;HOSPITAL GENERAL DE AGUDOS DR. I. PIROVANO;
Cirugia;Otorrinolaringología;212;31;243;176;1;177;63;240;2840;1310;776;358;4613;546;3093;42;2016;2125;HOSPITAL GENERAL DE AGUDOS DR. I. PIROVANO;
Cirugia;Urología;326;70;396;363;4;367;28;395;3968;3023;1084;826;7618;765;3643;101;2016;2125;HOSPITAL GENERAL DE AGUDOS DR. I. PIROVANO;
Cirugia;Subtotal Cirugia;3268;534;3802;3066;85;3151;622;3773;53332;38548;14572;10532;7228;1022;2589;225;2016;2125;HOSPITAL GENERAL DE AGUDOS DR. I. PIROVANO;
Pediatria;Recien Nacido Sano;784;0;784;697;0;697;90;787;11346;2477;31;677;2183;315;2539;0;2016;2125;HOSPITAL GENERAL DE AGUDOS DR. I. PIROVANO;
Pediatria;Neonatología;231;90;321;313;5;318;0;318;3375;2566;922;701;7603;807;3449;157;2016;2125;HOSPITAL GENERAL DE AGUDOS DR. I. PIROVANO;
Pediatria;Pediatría;923;0;923;924;0;924;0;924;9516;3188;26;871;335;345;3554;0;2016;2125;HOSPITAL GENERAL DE AGUDOS DR. I. PIROVANO;
Pediatria;Subtotal Pediatria;1938;90;2028;1934;5;1939;90;2029;24237;8231;6622;2249;3396;406;3064;25;2016;2125;HOSPITAL GENERAL DE AGUDOS DR. I. PIROVANO;
Tocoginecologia;Obstetricia;1653;4;1657;1558;0;1558;101;1659;11151;5913;3047;1616;5303;356;5445;0;2016;2125;HOSPITAL GENERAL DE AGUDOS DR. I. PIROVANO;
Tocoginecologia;Subtotal Tocoginecologia;1653;4;1657;1558;0;1558;101;1659;11151;5913;3047;1616;5303;356;5445;0;2016;2125;HOSPITAL GENERAL DE AGUDOS DR. I. PIROVANO;
Urgencia;Terapia Intermedia;0;0;0;0;0;0;0;0;1464;0;4;0;0;0;;;2016;2125;HOSPITAL GENERAL DE AGUDOS DR. I. PIROVANO;
Urgencia;Terapia Intensiva;89;237;326;9;85;94;232;326;3676;3506;1004;958;9538;1075;3246;2607;2016;2125;HOSPITAL GENERAL DE AGUDOS DR. I. PIROVANO;
Urgencia;Subtotal Urgencia;89;237;326;9;85;94;232;326;5140;3506;1404;958;6821;1075;2321;2607;2016;2125;HOSPITAL GENERAL DE AGUDOS DR. I. PIROVANO;
Urgencia;Total Hospital;8186;1295;9481;7714;432;8146;1295;9441;126311;83382;34511;22782;6601;1024;236;53;2016;2125;HOSPITAL GENERAL DE AGUDOS DR. I. PIROVANO;
Medicina;Cardiología;154;323;477;381;2;383;90;473;5922;3807;1618;104;6429;805;2923;42;2016;2162;HOSPITAL GENERAL DE AGUDOS J. M. RAMOS MEJIA;
Medicina;Clínica Médica;446;1037;1483;1137;155;1292;195;1487;35970;31682;9828;8656;8808;2131;1513;1042;2016;2162;HOSPITAL GENERAL DE AGUDOS J. M. RAMOS MEJIA;
Medicina;Dermatología;125;21;146;123;0;123;20;143;4060;2862;1109;782;7049;2001;1289;0;2016;2162;HOSPITAL GENERAL DE AGUDOS J. M. RAMOS MEJIA;
Medicina;Stroke ;16;9;25;16;0;16;8;24;209;148;57;4;7081;617;4203;0;2016;2162;HOSPITAL GENERAL DE AGUDOS J. M. RAMOS MEJIA;
Medicina;Hematología;133;51;184;156;8;164;21;185;3750;2978;1025;814;7941;161;1806;432;2016;2162;HOSPITAL GENERAL DE AGUDOS J. M. RAMOS MEJIA;
Medicina;Neurología;508;117;625;574;5;579;45;624;5381;3528;147;964;6556;565;4244;8;2016;2162;HOSPITAL GENERAL DE AGUDOS J. M. RAMOS MEJIA;
Medicina;Tisiología;75;57;132;115;2;117;16;133;6070;3263;1658;892;5376;2453;802;15;2016;2162;HOSPITAL GENERAL DE AGUDOS J. M. RAMOS MEJIA;
Medicina;Unidad Coronaria;326;167;493;116;35;151;342;493;2542;2134;695;583;8395;433;7098;71;2016;2162;HOSPITAL GENERAL DE AGUDOS J. M. RAMOS MEJIA;
Medicina;Subtotal Medicina;1783;1782;3565;2618;207;2825;737;3562;63904;50402;1746;13771;7887;1415;204;581;2016;2162;HOSPITAL GENERAL DE AGUDOS J. M. RAMOS MEJIA;
Cirugia;Cirugía General;938;250;1188;1052;12;1064;126;1190;21116;14278;5769;3901;6762;12;2063;101;2016;2162;HOSPITAL GENERAL DE AGUDOS J. M. RAMOS MEJIA;
Cirugia;Cirugía Plástica Y Reparadora - niÃ±os;398;6;404;404;0;404;2;406;4417;1012;1207;277;2291;249;3364;0;2016;2162;HOSPITAL GENERAL DE AGUDOS J. M. RAMOS MEJIA;
Cirugia;Ginecología;297;10;307;295;1;296;10;306;5071;1724;1386;471;34;563;2209;33;2016;2162;HOSPITAL GENERAL DE AGUDOS J. M. RAMOS MEJIA;
Cirugia;Neurocirugía;103;80;183;128;0;128;55;183;785;758;214;207;9656;414;8532;0;2016;2162;HOSPITAL GENERAL DE AGUDOS J. M. RAMOS MEJIA;
Cirugia;Ortopedia Y Traumatología;236;53;289;249;10;259;33;292;8799;6468;2404;1767;7351;2215;1215;342;2016;2162;HOSPITAL GENERAL DE AGUDOS J. M. RAMOS MEJIA;
Cirugia;Otorrinolaringología;87;0;87;86;0;86;1;87;76;76;21;21;100;87;41897;0;2016;2162;HOSPITAL GENERAL DE AGUDOS J. M. RAMOS MEJIA;
Cirugia;Urología;160;137;297;269;4;273;20;293;5290;3540;1445;967;6692;1208;2027;137;2016;2162;HOSPITAL GENERAL DE AGUDOS J. M. RAMOS MEJIA;
Cirugia;Subtotal Cirugia;2219;536;2755;2483;27;2510;247;2757;45554;27856;12446;7611;6115;101;2215;98;2016;2162;HOSPITAL GENERAL DE AGUDOS J. M. RAMOS MEJIA;
Pediatria;Recien Nacido Sano;1261;0;1261;1193;0;1193;72;1265;7156;3597;1955;983;5027;284;647;0;2016;2162;HOSPITAL GENERAL DE AGUDOS J. M. RAMOS MEJIA;
Pediatria;Neonatología;152;73;225;223;4;227;1;228;4360;2394;1191;654;5491;105;1914;175;2016;2162;HOSPITAL GENERAL DE AGUDOS J. M. RAMOS MEJIA;
Pediatria;Pediatría;564;5;569;571;1;572;1;573;7760;2603;212;711;3354;454;2703;17;2016;2162;HOSPITAL GENERAL DE AGUDOS J. M. RAMOS MEJIA;
Pediatria;Subtotal Pediatria;1977;78;2055;1987;5;1992;74;2066;19276;8594;5267;2348;4458;416;3923;24;2016;2162;HOSPITAL GENERAL DE AGUDOS J. M. RAMOS MEJIA;
Tocoginecologia;Obstetricia;1792;12;1804;1797;0;1797;13;1810;8950;6970;2445;1904;7788;385;7402;0;2016;2162;HOSPITAL GENERAL DE AGUDOS J. M. RAMOS MEJIA;
Tocoginecologia;Subtotal Tocoginecologia;1792;12;1804;1797;0;1797;13;1810;8950;6970;2445;1904;7788;385;7402;0;2016;2162;HOSPITAL GENERAL DE AGUDOS J. M. RAMOS MEJIA;
Urgencia;Guardia Del Día;2570;136;2706;740;419;1159;1542;2701;4693;5630;1282;1538;11997;208;21065;1551;2016;2162;HOSPITAL GENERAL DE AGUDOS J. M. RAMOS MEJIA;
Urgencia;Terapia Intensiva;24;321;345;10;85;95;252;347;4222;3784;1154;1034;8963;109;3008;245;2016;2162;HOSPITAL GENERAL DE AGUDOS J. M. RAMOS MEJIA;
Urgencia;Subtotal Urgencia;2594;457;3051;750;504;1254;1794;3048;8915;9414;2436;2572;1056;309;12513;1654;2016;2162;HOSPITAL GENERAL DE AGUDOS J. M. RAMOS MEJIA;
Urgencia;Total Hospital;10365;2865;13230;9635;743;10378;2865;13243;146599;103236;40054;28207;7042;995;2591;716;2016;2162;HOSPITAL GENERAL DE AGUDOS J. M. RAMOS MEJIA;
Medicina;Cardiología;146;154;300;261;1;262;39;301;4392;1447;12;395;3295;481;2508;33;2016;2119;HOSPITAL GENERAL DE AGUDOS B. RIVADAVIA;
Medicina;Clínica Médica;721;120;841;623;110;733;108;841;20759;15534;5672;4244;7483;1847;1483;1308;2016;2119;HOSPITAL GENERAL DE AGUDOS B. RIVADAVIA;
Medicina;Nutrición;81;4;85;76;1;77;7;84;3398;1120;928;306;3296;1333;905;119;2016;2119;HOSPITAL GENERAL DE AGUDOS B. RIVADAVIA;
Medicina;Curieterapia;23;0;23;23;0;23;0;23;2152;51;588;14;237;222;391;0;2016;2119;HOSPITAL GENERAL DE AGUDOS B. RIVADAVIA;
Medicina;Unidad Coronaria;201;59;260;63;18;81;179;260;2117;1274;578;348;6018;49;4495;692;2016;2119;HOSPITAL GENERAL DE AGUDOS B. RIVADAVIA;
Medicina;Subtotal Medicina;1172;337;1509;1046;130;1176;333;1509;32818;19426;8967;5308;5919;1287;1683;861;2016;2119;HOSPITAL GENERAL DE AGUDOS B. RIVADAVIA;
Cirugia;Cirugía General;653;56;709;646;9;655;50;705;13895;4578;3796;1251;3295;649;1857;128;2016;2119;HOSPITAL GENERAL DE AGUDOS B. RIVADAVIA;
Cirugia;Neurocirugía;58;39;97;55;1;56;39;95;6570;239;18;65;364;252;528;105;2015;2111;HOSPITAL DE OFTALMOLOGIA SANTA LUCIA;
Cirugia;Oftalmología;4225;1;4226;4164;0;4164;2;4166;5840;2893;16;793;4954;69;26038;0;2015;2111;HOSPITAL DE OFTALMOLOGIA SANTA LUCIA;
Cirugia;Subtotal Cirugia;4283;40;4323;4219;1;4220;41;4261;12410;3132;34;858;2524;74;12532;2;2015;2111;HOSPITAL DE OFTALMOLOGIA SANTA LUCIA;
Urgencia;Terapia Intensiva;1;39;40;3;0;3;38;41;1095;74;3;2;676;18;1367;0;2015;2111;HOSPITAL DE OFTALMOLOGIA SANTA LUCIA;
Urgencia;Subtotal Urgencia;1;39;40;3;0;3;38;41;1095;74;3;2;676;18;1367;0;2015;2111;HOSPITAL DE OFTALMOLOGIA SANTA LUCIA;
Urgencia;Total Hospital;4284;79;4363;4222;1;4223;79;4302;13505;3206;37;878;2374;76;11414;2;2015;2111;HOSPITAL DE OFTALMOLOGIA SANTA LUCIA;
sticas de Salud - MSGC;Fuente : Movimiento Hospitalario;2015;;;;;;;;;;2015;;;;;;2015;2111;HOSPITAL DE OFTALMOLOGIA SANTA LUCIA;
Medicina;Clínica Médica;0;142;142;20;2;22;115;137;11253;9052;3083;248;8044;6607;444;146;2015;2117;HOSPITAL DE SALUD MENTAL J. T. BORDA;
Medicina;Neurología;0;5;5;2;0;2;9;11;2128;1503;583;412;7063;13664;189;0;2015;2117;HOSPITAL DE SALUD MENTAL J. T. BORDA;
Medicina;Psicopatologia Y Salud Mental;872;998;1870;843;4;847;1036;1883;255918;212624;70115;58253;8308;11292;269;21;2015;2117;HOSPITAL DE SALUD MENTAL J. T. BORDA;
Medicina;Subtotal Medicina;872;1145;2017;865;6;871;1160;2031;269299;223179;73781;61145;8287;10989;275;3;2015;2117;HOSPITAL DE SALUD MENTAL J. T. BORDA;
Cirugia;Cirugía General;0;51;51;15;1;16;36;52;3340;2540;915;696;7605;4885;568;192;2015;2117;HOSPITAL DE SALUD MENTAL J. T. BORDA;
Cirugia;Subtotal Cirugia;0;51;51;15;1;16;36;52;3340;2540;915;696;7605;4885;568;192;2015;2117;HOSPITAL DE SALUD MENTAL J. T. BORDA;
Cirugia;Total Hospital;872;1196;2068;880;7;887;1196;2083;272639;225719;74696;61841;8279;25447;119;79;2015;2117;HOSPITAL DE SALUD MENTAL J. T. BORDA;
sticas de Salud - MSGC;Fuente : Movimiento Hospitalario;2015;;;;;;;;;;2015;;;;;;2015;2117;HOSPITAL DE SALUD MENTAL J. T. BORDA;
Medicina;Clínica Médica;0;43;43;8;12;20;22;42;8395;2993;23;82;3565;7126;183;2857;2015;2116;HOSPITAL DE SALUD MENTAL BRAULIO MOYANO;
Medicina;Psicopatologia Y Salud Mental;940;783;1723;970;12;982;816;1798;317834;256920;87078;70389;8083;14289;206;67;2015;2116;HOSPITAL DE SALUD MENTAL BRAULIO MOYANO;
Medicina;Subtotal Medicina;940;826;1766;978;24;1002;838;1840;326229;259913;89378;71209;7967;14126;206;13;2015;2116;HOSPITAL DE SALUD MENTAL BRAULIO MOYANO;
Cirugia;Cirugía General;0;40;40;8;0;8;28;36;5856;1306;1604;358;223;3628;224;0;2015;2116;HOSPITAL DE SALUD MENTAL BRAULIO MOYANO;
Cirugia;Ginecología;0;12;12;0;0;0;12;12;5840;601;16;165;1029;5008;75;0;2015;2116;HOSPITAL DE SALUD MENTAL BRAULIO MOYANO;
Cirugia;Subtotal Cirugia;0;52;52;8;0;8;40;48;11696;1907;3204;522;163;3973;15;0;2015;2116;HOSPITAL DE SALUD MENTAL BRAULIO MOYANO;
Cirugia;Total Hospital;940;878;1818;986;24;1010;878;1888;337925;261820;92582;71732;7748;25923;109;238;2015;2116;HOSPITAL DE SALUD MENTAL BRAULIO MOYANO;
sticas de Salud - MSGC;Fuente : Movimiento Hospitalario;2015;;;;;;;;;;2015;;;;;;2015;2116;HOSPITAL DE SALUD MENTAL BRAULIO MOYANO;
Pediatria;Psiquiatria;461;21;482;434;0;434;21;455;23360;13979;64;383;5984;3072;711;0;2015;2165;HOSPITAL INFANTO JUVENIL C. TOBAR GARCIA;
Pediatria;Subtotal Pediatria;461;21;482;434;0;434;21;455;23360;13979;64;383;5984;3072;711;0;2015;2165;HOSPITAL INFANTO JUVENIL C. TOBAR GARCIA;
Pediatria;Total Hospital;461;21;482;434;0;434;21;455;23360;13979;64;383;5984;3221;678;0;2015;2165;HOSPITAL INFANTO JUVENIL C. TOBAR GARCIA;
sticas de Salud - MSGC;Fuente : Movimiento Hospitalario;2015;;;;;;;;;;2015;;;;;;2015;2165;HOSPITAL INFANTO JUVENIL C. TOBAR GARCIA;
Medicina;Psicopatologia Y Salud Mental;11;234;245;216;0;216;28;244;13661;14692;3743;4025;10755;6021;652;0;2015;2108;HOSPITAL DE EMERGENCIAS PSIQUIATRICAS TORCUATO DE ALVEAR;Nota : La información de Internación del Hospital Alvear corresponde a los meses de enero a octubre 2015
Medicina;Adolescencia;20;25;45;40;0;40;4;44;4914;2738;1346;75;5572;6223;327;0;2015;2108;HOSPITAL DE EMERGENCIAS PSIQUIATRICAS TORCUATO DE ALVEAR;Nota : La información de Internación del Hospital Alvear corresponde a los meses de enero a octubre 2015
Medicina;Subtotal Medicina;31;259;290;256;0;256;32;288;18575;17430;5089;4775;9384;6052;566;0;2015;2108;HOSPITAL DE EMERGENCIAS PSIQUIATRICAS TORCUATO DE ALVEAR;Nota : La información de Internación del Hospital Alvear corresponde a los meses de enero a octubre 2015
Urgencia;Emergencia;336;32;368;108;0;108;259;367;4567;4740;1251;1299;10379;1292;2933;0;2015;2108;HOSPITAL DE EMERGENCIAS PSIQUIATRICAS TORCUATO DE ALVEAR;Nota : La información de Internación del Hospital Alvear corresponde a los meses de enero a octubre 2015
Urgencia;Subtotal Urgencia;336;32;368;108;0;108;259;367;4567;4740;1251;1299;10379;1292;2933;0;2015;2108;HOSPITAL DE EMERGENCIAS PSIQUIATRICAS TORCUATO DE ALVEAR;Nota : La información de Internación del Hospital Alvear corresponde a los meses de enero a octubre 2015
Urgencia;Total Hospital;367;291;658;364;0;364;291;655;23142;22170;634;6074;958;6091;574;0;2015;2108;HOSPITAL DE EMERGENCIAS PSIQUIATRICAS TORCUATO DE ALVEAR;Nota : La información de Internación del Hospital Alvear corresponde a los meses de enero a octubre 2015
Medicina;Fisiatría;74;0;74;81;2;83;0;83;25460;18493;6975;5067;7264;22281;119;241;2015;2113;HOSPITAL DE REHABILITACION M. ROCCA;
Medicina;Subtotal Medicina;74;0;74;81;2;83;0;83;25460;18493;6975;5067;7264;22281;119;241;2015;2113;HOSPITAL DE REHABILITACION M. ROCCA;
Cirugia;Cirugía General;114;0;114;114;0;114;0;114;1913;765;524;21;3999;671;2175;0;2015;2113;HOSPITAL DE REHABILITACION M. ROCCA;
Cirugia;Subtotal Cirugia;114;0;114;114;0;114;0;114;1913;765;524;21;3999;671;2175;0;2015;2113;HOSPITAL DE REHABILITACION M. ROCCA;
Cirugia;Total Hospital;188;0;188;195;2;197;0;197;27373;19258;7499;5276;7035;9776;263;102;2015;2113;HOSPITAL DE REHABILITACION M. ROCCA;
sticas de Salud - MSGC;Fuente : Movimiento Hospitalario;2015;;;;;;;;;;2015;;;;;;2015;2113;HOSPITAL DE REHABILITACION M. ROCCA;
Medicina;Fisiatría;115;12;127;117;1;118;3;121;14864;7087;4072;1942;4768;5857;297;83;2015;2114;INSTITUTO DE REHABILITACION PSICOFISICA (I.R.E.P.);
Medicina;Subtotal Medicina;115;12;127;117;1;118;3;121;14864;7087;4072;1942;4768;5857;297;83;2015;2114;INSTITUTO DE REHABILITACION PSICOFISICA (I.R.E.P.);
Cirugia;Cirugía General;499;74;573;495;1;496;83;579;7570;2477;2074;679;3272;428;2792;17;2015;2114;INSTITUTO DE REHABILITACION PSICOFISICA (I.R.E.P.);
Cirugia;Subtotal Cirugia;499;74;573;495;1;496;83;579;7570;2477;2074;679;3272;428;2792;17;2015;2114;INSTITUTO DE REHABILITACION PSICOFISICA (I.R.E.P.);
Cirugia;Total Hospital;614;86;700;612;2;614;86;700;22434;9564;6146;262;4263;1558;999;33;2015;2114;INSTITUTO DE REHABILITACION PSICOFISICA (I.R.E.P.);
sticas de Salud - MSGC;Fuente : Movimiento Hospitalario;2015;;;;;;;;;;2015;;;;;;2015;2114;INSTITUTO DE REHABILITACION PSICOFISICA (I.R.E.P.);
Medicina;Terapia Prolongada;516;51;567;429;9;438;129;567;3092;2025;847;555;6549;357;6693;159;2015;2115;HOSPITAL DE REHABILITACION RESPIRATORIA MARIA FERRER;
Medicina;Terapia Intermedia;569;230;799;661;35;696;104;800;7496;5824;2054;1596;7769;728;3895;438;2015;2115;HOSPITAL DE REHABILITACION RESPIRATORIA MARIA FERRER;
Medicina;Subtotal Medicina;1085;281;1366;1090;44;1134;233;1367;10588;7849;2901;215;7413;574;4712;322;2015;2115;HOSPITAL DE REHABILITACION RESPIRATORIA MARIA FERRER;
Urgencia;Terapia Intensiva;151;163;314;52;53;105;211;316;2924;2154;801;59;7367;682;3945;1677;2015;2115;HOSPITAL DE REHABILITACION RESPIRATORIA MARIA FERRER;
Urgencia;Subtotal Urgencia;151;163;314;52;53;105;211;316;2924;2154;801;59;7367;682;3945;1677;2015;2115;HOSPITAL DE REHABILITACION RESPIRATORIA MARIA FERRER;
Urgencia;Total Hospital;1236;444;1680;1142;97;1239;444;1683;13512;10003;3702;2741;7403;807;3347;783;2015;2115;HOSPITAL DE REHABILITACION RESPIRATORIA MARIA FERRER;
sticas de Salud - MSGC;Fuente : Movimiento Hospitalario;2015;;;;;;;;;;2015;;;;;;2015;2115;HOSPITAL DE REHABILITACION RESPIRATORIA MARIA FERRER;
Medicina;Cardiología;19;222;241;169;6;175;66;241;3670;1655;1003;452;451;687;2403;249;2016;2126;HOSPITAL GENERAL DE AGUDOS DR. T. ALVAREZ;
Medicina;Clínica Médica;219;1050;1269;935;200;1135;145;1280;23932;18873;6539;5157;7886;1474;1958;1563;2016;2126;HOSPITAL GENERAL DE AGUDOS DR. T. ALVAREZ;
Medicina;Neurología;3;13;16;14;0;14;2;16;367;104;1;28;2834;65;1596;0;2016;2126;HOSPITAL GENERAL DE AGUDOS DR. T. ALVAREZ;
Medicina;Psicopatologia Y Salud Mental;1;43;44;37;0;37;6;43;7707;7183;2106;1963;932;16705;204;0;2016;2126;HOSPITAL GENERAL DE AGUDOS DR. T. ALVAREZ;
Medicina;Unidad Coronaria;34;175;209;62;20;82;126;208;2203;1388;602;379;63;667;3456;962;2016;2126;HOSPITAL GENERAL DE AGUDOS DR. T. ALVAREZ;
Medicina;Subtotal Medicina;276;1503;1779;1217;226;1443;345;1788;37879;29203;10349;7979;771;1633;1728;1264;2016;2126;HOSPITAL GENERAL DE AGUDOS DR. T. ALVAREZ;
Cirugia;Cirugía General;518;666;1184;1005;10;1015;155;1170;11745;8091;3209;2211;6889;692;3646;85;2016;2126;HOSPITAL GENERAL DE AGUDOS DR. T. ALVAREZ;
Cirugia;Ginecología;196;43;239;229;0;229;7;236;1470;1236;402;338;8408;524;5876;0;2016;2126;HOSPITAL GENERAL DE AGUDOS DR. T. ALVAREZ;
Cirugia;Ortopedia Y Traumatología;189;209;398;333;7;340;52;392;8079;5905;2207;1613;7309;1506;1776;179;2016;2126;HOSPITAL GENERAL DE AGUDOS DR. T. ALVAREZ;
Cirugia;Urología;51;38;89;69;0;69;21;90;734;552;201;151;752;613;4488;0;2016;2126;HOSPITAL GENERAL DE AGUDOS DR. T. ALVAREZ;
Cirugia;Subtotal Cirugia;954;956;1910;1636;17;1653;235;1888;22028;15784;6019;4313;7165;836;3137;9;2016;2126;HOSPITAL GENERAL DE AGUDOS DR. T. ALVAREZ;
Pediatria;Recien Nacido Sano;1253;189;1442;1280;0;1280;170;1450;7340;3814;2005;1042;5196;263;723;0;2016;2126;HOSPITAL GENERAL DE AGUDOS DR. T. ALVAREZ;
Pediatria;Neonatología;359;171;530;335;3;338;190;528;3674;2390;1004;653;6505;453;526;57;2016;2126;HOSPITAL GENERAL DE AGUDOS DR. T. ALVAREZ;
Pediatria;Pediatría;1382;1;1383;1385;0;1385;0;1385;9175;3794;2507;1037;4135;274;5525;0;2016;2126;HOSPITAL GENERAL DE AGUDOS DR. T. ALVAREZ;
Pediatria;Subtotal Pediatria;2994;361;3355;3000;3;3003;360;3363;20189;9998;5516;2732;4952;297;6097;9;2016;2126;HOSPITAL GENERAL DE AGUDOS DR. T. ALVAREZ;
Tocoginecologia;Obstetricia;2103;8;2111;2090;1;2091;33;2124;11010;6287;3008;1718;571;296;7061;5;2016;2126;HOSPITAL GENERAL DE AGUDOS DR. T. ALVAREZ;
Tocoginecologia;Subtotal Tocoginecologia;2103;8;2111;2090;1;2091;33;2124;11010;6287;3008;1718;571;296;7061;5;2016;2126;HOSPITAL GENERAL DE AGUDOS DR. T. ALVAREZ;
Urgencia;Guardia Del Día;3145;61;3206;1035;194;1229;1975;3204;5518;3374;1508;922;6115;105;21252;605;2016;2126;HOSPITAL GENERAL DE AGUDOS DR. T. ALVAREZ;
Urgencia;Terapia Intensiva;3;178;181;15;47;62;119;181;2846;2354;778;643;8271;1301;2328;2597;2016;2126;HOSPITAL GENERAL DE AGUDOS DR. T. ALVAREZ;
Urgencia;Subtotal Urgencia;3148;239;3387;1050;241;1291;2094;3385;8364;5728;2285;1565;6848;169;14812;712;2016;2126;HOSPITAL GENERAL DE AGUDOS DR. T. ALVAREZ;
Urgencia;Total Hospital;9475;3067;12542;8993;488;9481;3067;12548;99470;67000;27178;18306;6736;707;3489;515;2016;2126;HOSPITAL GENERAL DE AGUDOS DR. T. ALVAREZ;
Medicina;Cardiología Intervencionista;340;0;340;340;0;340;0;340;492;340;134;93;6911;1;25293;0;2016;2122;HOSPITAL GENERAL DE AGUDOS DR C. ARGERICH;
Medicina;Cardiología;258;361;619;486;15;501;118;619;9200;8126;2514;222;8833;1313;2463;242;2016;2122;HOSPITAL GENERAL DE AGUDOS DR C. ARGERICH;
Medicina;Clínica Médica;222;488;710;485;57;542;167;709;12444;11568;34;3161;9296;1632;2085;804;2016;2122;HOSPITAL GENERAL DE AGUDOS DR C. ARGERICH;
Medicina;Unidad Coronaria;208;159;367;75;31;106;261;367;2028;1873;554;512;9236;51;6623;845;2016;2122;HOSPITAL GENERAL DE AGUDOS DR C. ARGERICH;
Medicina;Subtotal Medicina;1028;1008;2036;1386;103;1489;546;2035;24164;21907;6602;5986;9066;1077;3082;506;2016;2122;HOSPITAL GENERAL DE AGUDOS DR C. ARGERICH;
Cirugia;Cirugía General;2714;260;2974;2765;42;2807;152;2959;20130;18362;55;5017;9122;621;538;142;2016;2122;HOSPITAL GENERAL DE AGUDOS DR C. ARGERICH;
Cirugia;Cirugía Cardiovascular;146;83;229;139;8;147;80;227;5856;4650;16;127;7941;2048;1419;352;2016;2122;HOSPITAL GENERAL DE AGUDOS DR C. ARGERICH;
Cirugia;Ginecología;303;61;364;313;4;317;45;362;4758;4561;13;1246;9586;126;2785;11;2016;2122;HOSPITAL GENERAL DE AGUDOS DR C. ARGERICH;
Cirugia;Neurocirugía;158;144;302;210;12;222;84;306;8418;6728;23;1838;7992;2199;133;392;2016;2122;HOSPITAL GENERAL DE AGUDOS DR C. ARGERICH;
Cirugia;Ortopedia Y Traumatología;298;97;395;350;10;360;41;401;7868;6858;215;1874;8716;171;1865;249;2016;2122;HOSPITAL GENERAL DE AGUDOS DR C. ARGERICH;
Cirugia;Urología;382;29;411;381;3;384;26;410;3294;3178;9;868;9648;775;4556;73;2016;2122;HOSPITAL GENERAL DE AGUDOS DR C. ARGERICH;
Cirugia;Trasplante Renal;500;101;601;513;15;528;65;593;8302;6102;2268;1667;735;1029;2614;253;2016;2122;HOSPITAL GENERAL DE AGUDOS DR C. ARGERICH;
Cirugia;Subtotal Cirugia;4501;775;5276;4671;94;4765;493;5258;58626;50439;16018;13781;8604;959;3283;179;2016;2122;HOSPITAL GENERAL DE AGUDOS DR C. ARGERICH;
Pediatria;Recien Nacido Sano;1646;175;1821;1752;0;1752;83;1835;13542;4929;37;1347;364;269;4959;0;2016;2122;HOSPITAL GENERAL DE AGUDOS DR C. ARGERICH;
Pediatria;Neonatología;562;84;646;438;31;469;184;653;9942;6194;2716;1692;623;949;2404;475;2016;2122;HOSPITAL GENERAL DE AGUDOS DR C. ARGERICH;
Pediatria;Pediatría;488;29;517;516;0;516;2;518;6588;3222;18;88;4891;622;2878;0;2016;2122;HOSPITAL GENERAL DE AGUDOS DR C. ARGERICH;
Pediatria;Subtotal Pediatria;2696;288;2984;2706;31;2737;269;3006;30072;14345;8216;3919;477;477;3659;103;2016;2122;HOSPITAL GENERAL DE AGUDOS DR C. ARGERICH;
Tocoginecologia;Obstetricia;2723;87;2810;2712;2;2714;116;2830;13611;11234;3719;3069;8254;397;761;7;2016;2122;HOSPITAL GENERAL DE AGUDOS DR C. ARGERICH;
Tocoginecologia;Subtotal Tocoginecologia;2723;87;2810;2712;2;2714;116;2830;13611;11234;3719;3069;8254;397;761;7;2016;2122;HOSPITAL GENERAL DE AGUDOS DR C. ARGERICH;
Urgencia;Guardia Del Día;1823;22;1845;780;258;1038;804;1842;9303;9303;2542;2542;100;505;7247;1401;2016;2122;HOSPITAL GENERAL DE AGUDOS DR C. ARGERICH;
Urgencia;Terapia Intensiva;174;626;800;57;165;222;578;800;7993;6791;2184;1855;8496;849;3663;2063;2016;2122;HOSPITAL GENERAL DE AGUDOS DR C. ARGERICH;
Urgencia;Subtotal Urgencia;1997;648;2645;837;423;1260;1382;2642;17296;16094;4726;4397;9305;609;5591;1601;2016;2122;HOSPITAL GENERAL DE AGUDOS DR C. ARGERICH;
Urgencia;Total Hospital;12945;2806;15751;12312;653;12965;2806;15771;143769;114019;39281;31153;7931;879;3301;504;2016;2122;HOSPITAL GENERAL DE AGUDOS DR C. ARGERICH;
Medicina;Cardiología;64;176;240;118;1;119;119;238;5824;3831;1591;1047;6578;161;1496;42;2016;2123;HOSPITAL GENERAL DE AGUDOS DR. C. DURAND;
Medicina;Clínica Médica;465;376;841;639;78;717;127;844;16837;13337;46;3644;7921;158;1835;924;2016;2123;HOSPITAL GENERAL DE AGUDOS DR. C. DURAND;
Medicina;Geriatría;79;92;171;116;46;162;10;172;7913;7888;2162;2155;9968;4586;796;2674;2016;2123;HOSPITAL GENERAL DE AGUDOS DR. C. DURAND;
Medicina;Unidad Coronaria;187;145;332;110;40;150;180;330;2760;2131;754;582;7721;646;4376;1212;2016;2123;HOSPITAL GENERAL DE AGUDOS DR. C. DURAND;
Medicina;Subtotal Medicina;795;789;1584;983;165;1148;436;1584;33334;27187;9108;7428;8156;1716;1739;1042;2016;2123;HOSPITAL GENERAL DE AGUDOS DR. C. DURAND;
Cirugia;Cirugía General;686;141;827;704;2;706;126;832;3196;3219;873;88;10072;387;9528;24;2016;2123;HOSPITAL GENERAL DE AGUDOS DR. C. DURAND;
Cirugia;Cirugía Cardiovascular;17;97;114;32;5;37;77;114;1452;363;397;99;25;318;2874;439;2016;2123;HOSPITAL GENERAL DE AGUDOS DR. C. DURAND;
Cirugia;Cirugía Plástica Y Reparadora - niÃ±os;39;1;40;40;0;40;0;40;82;82;22;22;100;205;17854;0;2016;2123;HOSPITAL GENERAL DE AGUDOS DR. C. DURAND;
Cirugia;Oftalmología;8;1;9;8;0;8;1;9;26;26;7;7;100;289;12669;0;2016;2123;HOSPITAL GENERAL DE AGUDOS DR. C. DURAND;
Cirugia;Ortopedia Y Traumatología;371;30;401;367;4;371;28;399;3731;3736;1019;1021;10013;936;3914;1;2016;2123;HOSPITAL GENERAL DE AGUDOS DR. C. DURAND;
Cirugia;Otorrinolaringología;67;3;70;66;1;67;3;70;256;256;7;7;100;366;10008;143;2016;2123;HOSPITAL GENERAL DE AGUDOS DR. C. DURAND;
Cirugia;Urología;318;32;350;320;0;320;31;351;1029;1029;281;281;100;293;12485;0;2016;2123;HOSPITAL GENERAL DE AGUDOS DR. C. DURAND;
Cirugia;Vascular Periférico;23;20;43;25;0;25;17;42;244;245;67;67;10041;583;63;0;2016;2123;HOSPITAL GENERAL DE AGUDOS DR. C. DURAND;
Cirugia;Subtotal Cirugia;1529;325;1854;1562;12;1574;283;1857;10016;8956;2737;2447;8942;482;6786;65;2016;2123;HOSPITAL GENERAL DE AGUDOS DR. C. DURAND;
Pediatria;Recien Nacido Sano;1124;103;1227;1202;0;1202;21;1223;9139;4389;2497;1199;4802;359;4898;0;2016;2123;HOSPITAL GENERAL DE AGUDOS DR. C. DURAND;
Pediatria;Neonatología;335;141;476;231;12;243;231;474;7320;4259;20;1164;5818;899;237;253;2016;2123;HOSPITAL GENERAL DE AGUDOS DR. C. DURAND;
Pediatria;Pediatría;875;55;930;910;1;911;23;934;8835;5149;2414;1407;5828;551;3869;11;2016;2123;HOSPITAL GENERAL DE AGUDOS DR. C. DURAND;
Pediatria;Subtotal Pediatria;2334;299;2633;2343;13;2356;275;2631;25294;13797;6911;377;5455;524;3807;49;2016;2123;HOSPITAL GENERAL DE AGUDOS DR. C. DURAND;
Tocoginecologia;Tocoginecología;2188;82;2270;2177;1;2178;84;2262;15394;9824;4206;2684;6382;434;5378;4;2016;2123;HOSPITAL GENERAL DE AGUDOS DR. C. DURAND;
Tocoginecologia;Subtotal Tocoginecologia;2188;82;2270;2177;1;2178;84;2262;15394;9824;4206;2684;6382;434;5378;4;2016;2123;HOSPITAL GENERAL DE AGUDOS DR. C. DURAND;
Urgencia;Terapia Intermedia;54;24;78;30;2;32;47;79;2922;1310;798;358;4483;1658;99;253;2016;2123;HOSPITAL GENERAL DE AGUDOS DR. C. DURAND;
Urgencia;Cuidados Intermedios;52;155;207;29;9;38;167;205;1833;1733;501;473;9454;845;4093;439;2016;2123;HOSPITAL GENERAL DE AGUDOS DR. C. DURAND;
Urgencia;Guardia Del Día;922;30;952;345;205;550;396;946;6291;6228;1719;1702;99;658;5504;2167;2016;2123;HOSPITAL GENERAL DE AGUDOS DR. C. DURAND;
Urgencia;Terapia Intensiva;106;228;334;8;80;88;244;332;2944;2696;804;737;9158;812;4127;241;2016;2123;HOSPITAL GENERAL DE AGUDOS DR. C. DURAND;
Urgencia;Subtotal Urgencia;1134;437;1571;412;296;708;854;1562;13990;11967;3822;327;8554;766;4086;1895;2016;2123;HOSPITAL GENERAL DE AGUDOS DR. C. DURAND;
Urgencia;Total Hospital;7980;1932;9912;7477;487;7964;1932;9896;98028;71731;26784;19599;7317;901;2973;612;2016;2123;HOSPITAL GENERAL DE AGUDOS DR. C. DURAND;
Medicina;Cardiología;153;183;336;205;9;214;123;337;2291;1830;626;5;7988;543;5384;267;2016;2127;HOSPITAL GENERAL DE AGUDOS DR. J. A. FERNANDEZ;
Medicina;Clínica Médica;1086;474;1560;1155;143;1298;264;1562;28852;27565;7883;7531;9554;1765;1981;915;2016;2127;HOSPITAL GENERAL DE AGUDOS DR. J. A. FERNANDEZ;
Medicina;Unidad Coronaria;368;94;462;218;43;261;201;462;3276;2361;895;645;7207;511;5162;931;2016;2127;HOSPITAL GENERAL DE AGUDOS DR. J. A. FERNANDEZ;
Medicina;Subtotal Medicina;1607;751;2358;1578;195;1773;588;2361;34419;31756;9404;8677;9226;1345;2511;826;2016;2127;HOSPITAL GENERAL DE AGUDOS DR. J. A. FERNANDEZ;
Cirugia;Cirugía General;747;332;1079;833;13;846;229;1075;15001;13823;4099;3777;9215;1286;2623;121;2016;2127;HOSPITAL GENERAL DE AGUDOS DR. J. A. FERNANDEZ;
Cirugia;Ginecología;580;311;891;733;8;741;149;890;6781;5638;1853;154;8314;633;4804;9;2016;2127;HOSPITAL GENERAL DE AGUDOS DR. J. A. FERNANDEZ;
Cirugia;Neurocirugía;131;136;267;165;7;172;94;266;4165;3740;1138;1022;898;1406;2337;263;2016;2127;HOSPITAL GENERAL DE AGUDOS DR. J. A. FERNANDEZ;
Cirugia;Ortopedia Y Traumatología;1212;127;1339;1112;9;1121;213;1334;16003;12439;4372;3399;7773;932;3051;67;2016;2127;HOSPITAL GENERAL DE AGUDOS DR. J. A. FERNANDEZ;
Cirugia;Urología;217;34;251;202;1;203;47;250;3416;3213;933;878;9406;1285;2679;4;2016;2127;HOSPITAL GENERAL DE AGUDOS DR. J. A. FERNANDEZ;
Cirugia;Subtotal Cirugia;2887;940;3827;3045;38;3083;732;3815;45366;38853;12395;10616;8564;1018;3078;1;2016;2127;HOSPITAL GENERAL DE AGUDOS DR. J. A. FERNANDEZ;
Pediatria;Recien Nacido Sano;1369;30;1399;1312;0;1312;90;1402;10223;4238;2793;1158;4146;302;5019;0;2016;2127;HOSPITAL GENERAL DE AGUDOS DR. J. A. FERNANDEZ;
Pediatria;Neonatología;356;89;445;383;25;408;35;443;8077;6136;2207;1677;7597;1385;2007;564;2016;2127;HOSPITAL GENERAL DE AGUDOS DR. J. A. FERNANDEZ;
Pediatria;Pediatría;753;7;760;755;1;756;3;759;6492;3285;1774;898;506;433;4279;13;2016;2127;HOSPITAL GENERAL DE AGUDOS DR. J. A. FERNANDEZ;
Pediatria;Subtotal Pediatria;2478;126;2604;2450;26;2476;128;2604;24792;13659;6774;3732;5509;525;3844;1;2016;2127;HOSPITAL GENERAL DE AGUDOS DR. J. A. FERNANDEZ;
Tocoginecologia;Obstetricia;2130;16;2146;1852;0;1852;301;2153;10632;7251;2905;1981;682;337;7412;0;2016;2127;HOSPITAL GENERAL DE AGUDOS DR. J. A. FERNANDEZ;
Tocoginecologia;Subtotal Tocoginecologia;2130;16;2146;1852;0;1852;301;2153;10632;7251;2905;1981;682;337;7412;0;2016;2127;HOSPITAL GENERAL DE AGUDOS DR. J. A. FERNANDEZ;
Urgencia;Terapia Intermedia;20;183;203;18;10;28;174;202;4224;4093;1154;1118;969;2026;175;495;2016;2127;HOSPITAL GENERAL DE AGUDOS DR. J. A. FERNANDEZ;
Urgencia;Toxicología;209;9;218;191;0;191;27;218;2928;1882;8;514;6428;863;2725;0;2016;2127;HOSPITAL GENERAL DE AGUDOS DR. J. A. FERNANDEZ;
Urgencia;Terapia Intensiva;166;317;483;10;76;86;392;478;5223;4866;1427;133;9316;1018;335;159;2016;2127;HOSPITAL GENERAL DE AGUDOS DR. J. A. FERNANDEZ;
Urgencia;Subtotal Urgencia;395;509;904;219;86;305;593;898;12375;10841;3381;2962;876;1207;2656;958;2016;2127;HOSPITAL GENERAL DE AGUDOS DR. J. A. FERNANDEZ;
Urgencia;Total Hospital;9497;2342;11839;9144;345;9489;2342;11831;127584;102360;34859;27967;8023;1079;2722;364;2016;2127;HOSPITAL GENERAL DE AGUDOS DR. J. A. FERNANDEZ;
Medicina;Clínica Médica;144;548;692;556;72;628;59;687;17601;16039;4809;4382;9113;2335;1429;1048;2016;2161;HOSPITAL GENERAL DE AGUDOS J. A. PENNA;
Medicina;Subtotal Medicina;144;548;692;556;72;628;59;687;17601;16039;4809;4382;9113;2335;1429;1048;2016;2161;HOSPITAL GENERAL DE AGUDOS J. A. PENNA;
Cirugia;Cirugía General;1097;188;1285;1173;11;1184;97;1281;13179;7970;3601;2178;6047;622;3558;86;2016;2161;HOSPITAL GENERAL DE AGUDOS J. A. PENNA;
Cirugia;Ortopedia Y Traumatología;148;141;289;263;10;273;11;284;6068;5255;1658;1436;866;185;1713;352;2016;2161;HOSPITAL GENERAL DE AGUDOS J. A. PENNA;
Cirugia;Urología;213;31;244;226;1;227;16;243;2657;2586;726;707;9733;1064;3347;41;2016;2161;HOSPITAL GENERAL DE AGUDOS J. A. PENNA;
Cirugia;Subtotal Cirugia;1458;360;1818;1662;22;1684;124;1808;21904;15811;5985;432;7218;875;3021;122;2016;2161;HOSPITAL GENERAL DE AGUDOS J. A. PENNA;
Pediatria;Recien Nacido Sano;3045;311;3356;3183;0;3183;184;3367;17641;12021;482;3284;6814;357;6986;0;2016;2161;HOSPITAL GENERAL DE AGUDOS J. A. PENNA;
Pediatria;Neonatología;514;163;677;369;15;384;292;676;8435;5754;2305;1572;6822;851;2933;222;2016;2161;HOSPITAL GENERAL DE AGUDOS J. A. PENNA;
Pediatria;Pediatría;1106;10;1116;1114;0;1114;2;1116;8432;4894;2304;1337;5804;439;4844;0;2016;2161;HOSPITAL GENERAL DE AGUDOS J. A. PENNA;
Pediatria;Subtotal Pediatria;4665;484;5149;4666;15;4681;478;5159;34508;22669;9428;6194;6569;439;5472;29;2016;2161;HOSPITAL GENERAL DE AGUDOS J. A. PENNA;
Tocoginecologia;Tocoginecología;5371;193;5564;5373;13;5386;192;5578;24993;21102;6829;5766;8443;378;8168;23;2016;2161;HOSPITAL GENERAL DE AGUDOS J. A. PENNA;
Tocoginecologia;Subtotal Tocoginecologia;5371;193;5564;5373;13;5386;192;5578;24993;21102;6829;5766;8443;378;8168;23;2016;2161;HOSPITAL GENERAL DE AGUDOS J. A. PENNA;
Urgencia;Terapia Intermedia;14;126;140;7;25;32;110;142;1701;1696;465;463;9971;1194;3055;1761;2016;2161;HOSPITAL GENERAL DE AGUDOS J. A. PENNA;
Urgencia;Guardia Del Día;2904;3;2907;1880;236;2116;785;2901;10798;10787;295;2947;999;372;9833;814;2016;2161;HOSPITAL GENERAL DE AGUDOS J. A. PENNA;
Urgencia;Terapia Intensiva;33;193;226;10;55;65;159;224;2144;2105;586;575;9818;94;3824;2455;2016;2161;HOSPITAL GENERAL DE AGUDOS J. A. PENNA;
Urgencia;Subtotal Urgencia;2951;322;3273;1897;316;2213;1054;3267;14643;14588;4001;3986;9962;447;8166;967;2016;2161;HOSPITAL GENERAL DE AGUDOS J. A. PENNA;
Urgencia;Total Hospital;14589;1907;16496;14154;438;14592;1907;16499;113649;90209;31052;24647;7938;618;4699;3;2016;2161;HOSPITAL GENERAL DE AGUDOS J. A. PENNA;
Medicina;Psicopatologia Y Salud Mental;40;70;110;109;0;109;4;113;7332;5212;2003;1424;7109;4612;564;0;2016;2163;HOSPITAL GENERAL DE AGUDOS P. PIÑERO;
Medicina;Subtotal Medicina;40;70;110;109;0;109;4;113;7332;5212;2003;1424;7109;4612;564;0;2016;2163;HOSPITAL GENERAL DE AGUDOS P. PIÑERO;
Cirugia;Ginecología;408;32;440;409;2;411;28;439;2927;1460;8;399;4988;333;5489;46;2016;2163;HOSPITAL GENERAL DE AGUDOS P. PIÑERO;
Cirugia;Subtotal Cirugia;408;32;440;409;2;411;28;439;2927;1460;8;399;4988;333;5489;46;2016;2163;HOSPITAL GENERAL DE AGUDOS P. PIÑERO;
Medicina;Hepatopatía;217;21;238;180;13;193;43;236;3061;1770;836;484;5782;75;2822;551;2016;2110;HOSPITAL DE INFECCIOSAS F. MUÑIZ;
Medicina;Neumotisiología;685;86;771;655;12;667;112;779;24511;17255;6697;4714;704;2215;1163;154;2016;2110;HOSPITAL DE INFECCIOSAS F. MUÑIZ;
Medicina;Asistencia Respiratoria Intermedia;187;328;515;99;105;204;312;516;5000;3261;1366;891;6522;632;3777;2035;2016;2110;HOSPITAL DE INFECCIOSAS F. MUÑIZ;
Medicina;Zoopatología Médica;334;79;413;352;8;360;51;411;6497;4173;1775;114;6423;1015;2315;195;2016;2110;HOSPITAL DE INFECCIOSAS F. MUÑIZ;
Medicina;Subtotal Medicina;3308;811;4119;3103;224;3327;808;4135;93442;64973;25531;17752;6953;1571;162;542;2016;2110;HOSPITAL DE INFECCIOSAS F. MUÑIZ;
Cirugia;Cirugía General;621;87;708;603;14;617;87;704;8228;3666;2248;1002;4456;521;3132;199;2016;2110;HOSPITAL DE INFECCIOSAS F. MUÑIZ;
Cirugia;Subtotal Cirugia;621;87;708;603;14;617;87;704;8228;3666;2248;1002;4456;521;3132;199;2016;2110;HOSPITAL DE INFECCIOSAS F. MUÑIZ;
Pediatria;Infecciosas Pediatría;492;11;503;498;0;498;5;503;12355;5262;3376;1438;4259;1046;149;0;2016;2110;HOSPITAL DE INFECCIOSAS F. MUÑIZ;
Pediatria;Subtotal Pediatria;492;11;503;498;0;498;5;503;12355;5262;3376;1438;4259;1046;149;0;2016;2110;HOSPITAL DE INFECCIOSAS F. MUÑIZ;
Urgencia;Terapia Intensiva;146;187;333;21;117;138;196;334;3922;2462;1072;673;6277;737;3117;3503;2016;2110;HOSPITAL DE INFECCIOSAS F. MUÑIZ;
Urgencia;Subtotal Urgencia;146;187;333;21;117;138;196;334;3922;2462;1072;673;6277;737;3117;3503;2016;2110;HOSPITAL DE INFECCIOSAS F. MUÑIZ;
Urgencia;Total Hospital;4567;1096;5663;4225;355;4580;1096;5676;117947;76363;32226;20864;6474;1667;1421;775;2016;2110;HOSPITAL DE INFECCIOSAS F. MUÑIZ;
Medicina;Curieterapia;35;1;36;33;0;33;2;35;985;117;269;32;1188;334;1301;0;2016;2168;HOSPITAL MUNICIPAL DE ONCOLOGIA MARIE CURIE;
Medicina;Medicina;1628;31;1659;1201;408;1609;54;1663;18607;17023;5084;4651;9149;1024;3271;2453;2016;2168;HOSPITAL MUNICIPAL DE ONCOLOGIA MARIE CURIE;
Medicina;Subtotal Medicina;1663;32;1695;1234;408;1642;56;1698;19592;17140;5353;4683;8748;1009;3172;2403;2016;2168;HOSPITAL MUNICIPAL DE ONCOLOGIA MARIE CURIE;
Cirugia;Cirugía General;832;53;885;844;20;864;29;893;9803;4149;2678;1134;4232;465;3334;224;2016;2168;HOSPITAL MUNICIPAL DE ONCOLOGIA MARIE CURIE;
Cirugia;Subtotal Cirugia;832;53;885;844;20;864;29;893;9803;4149;2678;1134;4232;465;3334;224;2016;2168;HOSPITAL MUNICIPAL DE ONCOLOGIA MARIE CURIE;
Cirugia;Total Hospital;2495;85;2580;2078;428;2506;85;2591;29395;21289;8031;5817;7242;85;312;1708;2016;2168;HOSPITAL MUNICIPAL DE ONCOLOGIA MARIE CURIE;
Cirugia;Cirugía Plástica;718;1;719;718;0;718;1;719;3294;938;9;256;2848;13;7989;0;2016;2112;HOSPITAL DE QUEMADOS DR. ARTURO UMBERTO ILLIA;
Cirugia;Quemados ;13;146;159;100;1;101;58;159;3921;3209;1071;877;8184;2018;1484;63;2016;2112;HOSPITAL DE QUEMADOS DR. ARTURO UMBERTO ILLIA;
Cirugia;Quemados - Cuidados Generales - Adultos;61;161;222;193;0;193;28;221;5149;3069;1407;839;596;1389;1571;0;2016;2112;HOSPITAL DE QUEMADOS DR. ARTURO UMBERTO ILLIA;
Cirugia;Subtotal Cirugia;792;308;1100;1011;1;1012;87;1099;12364;7216;3378;1972;5836;657;3253;9;2016;2112;HOSPITAL DE QUEMADOS DR. ARTURO UMBERTO ILLIA;
Pediatria;Quemados ;41;283;324;85;0;85;239;324;4804;3660;1313;10;7619;113;2468;0;2016;2112;HOSPITAL DE QUEMADOS DR. ARTURO UMBERTO ILLIA;
Pediatria;Quemados - Cuidados Generales - Pediatría;50;243;293;286;0;286;8;294;2928;2607;8;712;8904;887;3675;0;2016;2112;HOSPITAL DE QUEMADOS DR. ARTURO UMBERTO ILLIA;
Pediatria;Subtotal Pediatria;91;526;617;371;0;371;247;618;7732;6267;2113;1712;8105;1014;2925;0;2016;2112;HOSPITAL DE QUEMADOS DR. ARTURO UMBERTO ILLIA;
Urgencia;Guardia;606;0;606;32;0;32;574;606;1098;107;3;29;974;18;202;0;2016;2112;HOSPITAL DE QUEMADOS DR. ARTURO UMBERTO ILLIA;
Urgencia;Quemados Cuidados Intensivos - Adultos;0;81;81;4;33;37;43;80;2196;1513;6;413;689;1891;1333;4125;2016;2112;HOSPITAL DE QUEMADOS DR. ARTURO UMBERTO ILLIA;
Urgencia;Terapia Intensiva;2;54;56;34;2;36;18;54;2198;1207;601;33;5491;2235;899;37;2016;2112;HOSPITAL DE QUEMADOS DR. ARTURO UMBERTO ILLIA;
Urgencia;Subtotal Urgencia;608;135;743;70;35;105;635;740;5492;2827;1501;772;5147;382;4932;473;2016;2112;HOSPITAL DE QUEMADOS DR. ARTURO UMBERTO ILLIA;
Internacion De Corta Estadia;Cirugia De Corta Estadia;12;0;12;12;0;12;0;12;12;12;3;3;100;1;366;0;2016;2112;HOSPITAL DE QUEMADOS DR. ARTURO UMBERTO ILLIA;
Internacion De Corta Estadia;Subtotal Internacion De Corta Estadia;12;0;12;12;0;12;0;12;12;12;3;3;100;1;366;0;2016;2112;HOSPITAL DE QUEMADOS DR. ARTURO UMBERTO ILLIA;
Internacion De Corta Estadia;Total Hospital;1503;969;2472;1464;36;1500;969;2469;25600;16322;6995;446;6376;1088;2145;24;2016;2112;HOSPITAL DE QUEMADOS DR. ARTURO UMBERTO ILLIA;
Medicina;Clínica Médica;800;153;953;658;84;742;210;952;14062;13183;3842;3602;9375;1385;2478;882;2016;2109;HOSPITAL DE GASTROENTEROLOGIA B. UDAONDO;
Medicina;Subtotal Medicina;800;153;953;658;84;742;210;952;14062;13183;3842;3602;9375;1385;2478;882;2016;2109;HOSPITAL DE GASTROENTEROLOGIA B. UDAONDO;
Cirugia;Cirugía;876;262;1138;1034;12;1046;188;1234;11055;8055;302;2201;7286;653;4085;97;2016;2109;HOSPITAL DE GASTROENTEROLOGIA B. UDAONDO;
Cirugia;Cirugía General;88;16;104;78;0;78;20;98;996;599;272;164;6014;611;3601;0;2016;2109;HOSPITAL DE GASTROENTEROLOGIA B. UDAONDO;
Cirugia;Subtotal Cirugia;964;278;1242;1112;12;1124;208;1332;12051;8654;3293;2364;7181;65;4045;9;2016;2109;HOSPITAL DE GASTROENTEROLOGIA B. UDAONDO;
Urgencia;Terapia Intensiva;81;156;237;7;63;70;169;239;2243;1874;613;512;8355;784;39;2636;2016;2109;HOSPITAL DE GASTROENTEROLOGIA B. UDAONDO;
Urgencia;Subtotal Urgencia;81;156;237;7;63;70;169;239;2243;1874;613;512;8355;784;39;2636;2016;2109;HOSPITAL DE GASTROENTEROLOGIA B. UDAONDO;
Urgencia;Total Hospital;1845;587;2432;1777;159;1936;587;2523;28356;23711;7748;6478;8362;1225;2499;821;2016;2109;HOSPITAL DE GASTROENTEROLOGIA B. UDAONDO;
Cirugia;Oftalmología;2254;0;2254;2253;0;2253;0;2253;7472;3061;2042;836;4097;136;11036;0;2016;2169;HOSPITAL OFTALMOLOGICO DR. PEDRO LAGLEYZE;
Cirugia;Subtotal Cirugia;2254;0;2254;2253;0;2253;0;2253;7472;3061;2042;836;4097;136;11036;0;2016;2169;HOSPITAL OFTALMOLOGICO DR. PEDRO LAGLEYZE;
Cirugia;Total Hospital;2254;0;2254;2253;0;2253;0;2253;7472;3061;2042;836;4097;136;11036;0;2016;2169;HOSPITAL OFTALMOLOGICO DR. PEDRO LAGLEYZE;
Cirugia;Neurocirugía;59;34;93;56;0;56;37;93;5699;255;1557;7;447;274;597;0;2016;2111;HOSPITAL DE OFTALMOLOGIA SANTA LUCIA;
Cirugia;Oftalmología;4062;2;4064;4047;0;4047;0;4047;7737;2654;2114;725;343;66;19144;0;2016;2111;HOSPITAL DE OFTALMOLOGIA SANTA LUCIA;
Cirugia;Subtotal Cirugia;4121;36;4157;4103;0;4103;37;4140;13436;2909;3671;795;2165;7;11277;0;2016;2111;HOSPITAL DE OFTALMOLOGIA SANTA LUCIA;
Urgencia;Terapia Intensiva;0;35;35;0;1;1;34;35;1098;88;3;24;801;251;1167;286;2016;2111;HOSPITAL DE OFTALMOLOGIA SANTA LUCIA;
Urgencia;Subtotal Urgencia;0;35;35;0;1;1;34;35;1098;88;3;24;801;251;1167;286;2016;2111;HOSPITAL DE OFTALMOLOGIA SANTA LUCIA;
Urgencia;Total Hospital;4121;71;4192;4103;1;4104;71;4175;14534;2997;3971;819;2062;73;10335;2;2016;2111;HOSPITAL DE OFTALMOLOGIA SANTA LUCIA;
Medicina;Clínica Médica;0;179;179;39;6;45;141;186;10495;8853;2867;2419;8435;476;649;323;2016;2117;HOSPITAL DE SALUD MENTAL J. T. BORDA;
Medicina;Psicopatologia Y Salud Mental;877;1003;1880;849;3;852;1057;1909;243964;208360;66657;56929;8541;10915;286;16;2016;2117;HOSPITAL DE SALUD MENTAL J. T. BORDA;
Medicina;Subtotal Medicina;877;1182;2059;888;9;897;1198;2095;254459;217213;69524;59348;8536;10368;301;43;2016;2117;HOSPITAL DE SALUD MENTAL J. T. BORDA;
Cirugia;Cirugía General;0;61;61;15;1;16;45;61;3650;2117;997;578;58;347;612;164;2016;2117;HOSPITAL DE SALUD MENTAL J. T. BORDA;
Cirugia;Subtotal Cirugia;0;61;61;15;1;16;45;61;3650;2117;997;578;58;347;612;164;2016;2117;HOSPITAL DE SALUD MENTAL J. T. BORDA;
Cirugia;Total Hospital;877;1243;2120;903;10;913;1243;2156;258109;219330;70522;59926;8498;24023;129;11;2016;2117;HOSPITAL DE SALUD MENTAL J. T. BORDA;
Medicina;Clínica Médica;0;26;26;4;7;11;20;31;8418;2365;23;646;2809;7629;135;2258;2016;2116;HOSPITAL DE SALUD MENTAL BRAULIO MOYANO;
Medicina;Psicopatologia Y Salud Mental;977;811;1788;1004;11;1015;823;1838;309307;236212;8451;64539;7637;12852;217;6;2016;2116;HOSPITAL DE SALUD MENTAL BRAULIO MOYANO;
Medicina;Subtotal Medicina;977;837;1814;1008;18;1026;843;1869;317725;238577;8681;65185;7509;12765;215;96;2016;2116;HOSPITAL DE SALUD MENTAL BRAULIO MOYANO;
Cirugia;Cirugía General;0;31;31;7;0;7;25;32;6073;1706;1659;466;2809;5331;193;0;2016;2116;HOSPITAL DE SALUD MENTAL BRAULIO MOYANO;
Cirugia;Ginecología;0;5;5;1;0;1;5;6;5856;514;16;14;878;8567;38;0;2016;2116;HOSPITAL DE SALUD MENTAL BRAULIO MOYANO;
Cirugia;Subtotal Cirugia;0;36;36;8;0;8;30;38;11929;2220;3259;607;1861;5842;117;0;2016;2116;HOSPITAL DE SALUD MENTAL BRAULIO MOYANO;
Cirugia;Total Hospital;977;873;1850;1016;18;1034;873;1907;329654;240797;90069;65792;7305;23288;115;174;2016;2116;HOSPITAL DE SALUD MENTAL BRAULIO MOYANO;
Pediatria;Psiquiatria;447;9;456;472;0;472;9;481;22689;14981;6199;4093;6603;3115;776;0;2016;2165;HOSPITAL INFANTO JUVENIL C. TOBAR GARCIA;
Pediatria;Subtotal Pediatria;447;9;456;472;0;472;9;481;22689;14981;6199;4093;6603;3115;776;0;2016;2165;HOSPITAL INFANTO JUVENIL C. TOBAR GARCIA;
Pediatria;Total Hospital;447;9;456;472;0;472;9;481;22689;14981;6199;4093;6603;3174;761;0;2016;2165;HOSPITAL INFANTO JUVENIL C. TOBAR GARCIA;
Medicina;Psicopatologia Y Salud Mental;8;171;179;157;0;157;18;175;13761;13459;376;3677;9781;7691;465;0;2016;2108;HOSPITAL DE EMERGENCIAS PSIQUIATRICAS TORCUATO DE ALVEAR;
Medicina;Adolescencia;22;20;42;39;0;39;2;41;4975;2377;1359;649;4778;5798;302;0;2016;2108;HOSPITAL DE EMERGENCIAS PSIQUIATRICAS TORCUATO DE ALVEAR;
Medicina;Subtotal Medicina;30;191;221;196;0;196;20;216;18736;15836;5119;4327;8452;7331;422;0;2016;2108;HOSPITAL DE EMERGENCIAS PSIQUIATRICAS TORCUATO DE ALVEAR;
Urgencia;Emergencia;281;20;301;108;0;108;191;299;4644;4226;1269;1155;91;1413;2356;0;2016;2108;HOSPITAL DE EMERGENCIAS PSIQUIATRICAS TORCUATO DE ALVEAR;
Tocoginecologia;Obstetricia;1669;17;1686;1622;0;1622;65;1687;10330;3945;283;1081;3819;234;5961;0;2017;2126;HOSPITAL GENERAL DE AGUDOS DR. T. ALVAREZ;
Tocoginecologia;Subtotal Tocoginecologia;1669;17;1686;1622;0;1622;65;1687;10330;3945;283;1081;3819;234;5961;0;2017;2126;HOSPITAL GENERAL DE AGUDOS DR. T. ALVAREZ;
Urgencia;Guardia Del Día;3091;55;3146;1067;134;1201;1947;3148;4059;3200;1112;877;7884;102;28308;426;2017;2126;HOSPITAL GENERAL DE AGUDOS DR. T. ALVAREZ;
Urgencia;Terapia Intensiva;6;275;281;8;99;107;174;281;2945;2228;807;61;7565;793;3483;3523;2017;2126;HOSPITAL GENERAL DE AGUDOS DR. T. ALVAREZ;
Urgencia;Subtotal Urgencia;3097;330;3427;1075;233;1308;2121;3429;7004;5428;1919;1487;775;158;1787;679;2017;2126;HOSPITAL GENERAL DE AGUDOS DR. T. ALVAREZ;
Urgencia;Total Hospital;8253;2987;11240;7831;448;8279;2987;11266;94322;55923;25842;15321;5929;675;3204;541;2017;2126;HOSPITAL GENERAL DE AGUDOS DR. T. ALVAREZ;
Medicina;Cardiología Intervencionista;474;0;474;474;0;474;0;474;588;474;161;13;8061;1;29423;0;2017;2122;HOSPITAL GENERAL DE AGUDOS DR C. ARGERICH;
Medicina;Cardiología;244;443;687;490;10;500;192;692;8802;7561;2412;2072;859;1093;287;145;2017;2122;HOSPITAL GENERAL DE AGUDOS DR C. ARGERICH;
Medicina;Clínica Médica;247;758;1005;723;109;832;173;1005;12410;11419;34;3128;9201;1136;2956;1085;2017;2122;HOSPITAL GENERAL DE AGUDOS DR C. ARGERICH;
Medicina;Unidad Coronaria;238;217;455;61;51;112;346;458;2435;2037;667;558;8366;445;6865;1114;2017;2122;HOSPITAL GENERAL DE AGUDOS DR C. ARGERICH;
Medicina;Subtotal Medicina;1203;1418;2621;1748;170;1918;711;2629;24235;21491;664;5888;8868;817;396;647;2017;2122;HOSPITAL GENERAL DE AGUDOS DR C. ARGERICH;
Cirugia;Cirugía General;2321;390;2711;2469;39;2508;213;2721;19345;18491;53;5066;9559;68;5134;143;2017;2122;HOSPITAL GENERAL DE AGUDOS DR C. ARGERICH;
Cirugia;Cirugía Cardiovascular;154;98;252;141;7;148;100;248;5840;5101;16;1398;8735;2057;155;282;2017;2122;HOSPITAL GENERAL DE AGUDOS DR C. ARGERICH;
Cirugia;Ginecología;303;92;395;331;1;332;66;398;4745;4281;13;1173;9022;1076;3062;25;2017;2122;HOSPITAL GENERAL DE AGUDOS DR C. ARGERICH;
Cirugia;Neurocirugía;167;173;340;181;3;184;157;341;8395;6677;23;1829;7954;1958;1483;88;2017;2122;HOSPITAL GENERAL DE AGUDOS DR C. ARGERICH;
Cirugia;Ortopedia Y Traumatología;368;117;485;428;14;442;34;476;7906;6748;2166;1849;8535;1418;2198;294;2017;2122;HOSPITAL GENERAL DE AGUDOS DR C. ARGERICH;
Cirugia;Urología;417;38;455;438;2;440;18;458;3285;3201;9;877;9744;699;5089;44;2017;2122;HOSPITAL GENERAL DE AGUDOS DR C. ARGERICH;
Cirugia;Trasplante Renal;524;108;632;537;11;548;85;633;8283;6230;2269;1707;7521;984;2789;174;2017;2122;HOSPITAL GENERAL DE AGUDOS DR C. ARGERICH;
Cirugia;Subtotal Cirugia;4254;1016;5270;4525;77;4602;673;5275;57799;50729;15835;13898;8777;962;3331;146;2017;2122;HOSPITAL GENERAL DE AGUDOS DR C. ARGERICH;
Pediatria;Recien Nacido Sano;1455;184;1639;1551;0;1551;89;1640;13505;4471;37;1225;3311;273;4432;0;2017;2122;HOSPITAL GENERAL DE AGUDOS DR C. ARGERICH;
Pediatria;Neonatología;525;91;616;418;9;427;187;614;9855;5661;27;1551;5744;922;2274;147;2017;2122;HOSPITAL GENERAL DE AGUDOS DR C. ARGERICH;
Pediatria;Pediatría;430;20;450;444;0;444;3;447;6570;2887;18;791;4394;646;2483;0;2017;2122;HOSPITAL GENERAL DE AGUDOS DR C. ARGERICH;
Pediatria;Subtotal Pediatria;2410;295;2705;2413;9;2422;279;2701;29930;13019;82;3567;435;482;3294;33;2017;2122;HOSPITAL GENERAL DE AGUDOS DR C. ARGERICH;
Tocoginecologia;Obstetricia;2546;136;2682;2422;0;2422;265;2687;13519;10151;3704;2781;7509;378;7255;0;2017;2122;HOSPITAL GENERAL DE AGUDOS DR C. ARGERICH;
Tocoginecologia;Subtotal Tocoginecologia;2546;136;2682;2422;0;2422;265;2687;13519;10151;3704;2781;7509;378;7255;0;2017;2122;HOSPITAL GENERAL DE AGUDOS DR C. ARGERICH;
Urgencia;Guardia Del Día;1996;17;2013;750;278;1028;983;2011;9576;9576;2624;2624;100;476;7665;1382;2017;2122;HOSPITAL GENERAL DE AGUDOS DR C. ARGERICH;
Urgencia;Terapia Intensiva;194;663;857;64;157;221;634;855;8126;7419;2226;2033;913;868;384;1836;2017;2122;HOSPITAL GENERAL DE AGUDOS DR C. ARGERICH;
Urgencia;Subtotal Urgencia;2190;680;2870;814;435;1249;1617;2866;17702;16995;485;4656;9601;593;5909;1518;2017;2122;HOSPITAL GENERAL DE AGUDOS DR C. ARGERICH;
Urgencia;Total Hospital;12603;3545;16148;11922;691;12613;3545;16158;143185;112385;39229;3079;7849;891;3215;548;2017;2122;HOSPITAL GENERAL DE AGUDOS DR C. ARGERICH;
Medicina;Cardiología;57;210;267;156;2;158;113;271;4738;3471;1298;951;7326;1281;2088;74;2017;2123;HOSPITAL GENERAL DE AGUDOS DR. C. DURAND;
Medicina;Clínica Médica;439;546;985;781;80;861;117;978;19218;15468;5265;4238;8049;1582;1857;818;2017;2123;HOSPITAL GENERAL DE AGUDOS DR. C. DURAND;
Medicina;Geriatría;75;103;178;123;45;168;12;180;7608;7430;2084;2036;9766;4128;864;25;2017;2123;HOSPITAL GENERAL DE AGUDOS DR. C. DURAND;
Medicina;Unidad Coronaria;212;143;355;105;40;145;210;355;2928;2059;802;564;7032;58;4425;1127;2017;2123;HOSPITAL GENERAL DE AGUDOS DR. C. DURAND;
Medicina;Subtotal Medicina;783;1002;1785;1165;167;1332;452;1784;34492;28428;945;7788;8242;1593;1888;936;2017;2123;HOSPITAL GENERAL DE AGUDOS DR. C. DURAND;
Urgencia;Subtotal Urgencia;281;20;301;108;0;108;191;299;4644;4226;1269;1155;91;1413;2356;0;2016;2108;HOSPITAL DE EMERGENCIAS PSIQUIATRICAS TORCUATO DE ALVEAR;
Urgencia;Total Hospital;311;211;522;304;0;304;211;515;23380;20062;6388;5481;8581;6599;476;0;2016;2108;HOSPITAL DE EMERGENCIAS PSIQUIATRICAS TORCUATO DE ALVEAR;
Urgencia;Meses informados de abril a diciembre;2016;;;;;;;;;;2016;;;;;;2016;2108;HOSPITAL DE EMERGENCIAS PSIQUIATRICAS TORCUATO DE ALVEAR;
Medicina;Fisiatría;89;0;89;81;2;83;0;83;23442;17696;6405;4835;7549;2132;13;241;2016;2113;HOSPITAL DE REHABILITACION M. ROCCA;
Medicina;Subtotal Medicina;89;0;89;81;2;83;0;83;23442;17696;6405;4835;7549;2132;13;241;2016;2113;HOSPITAL DE REHABILITACION M. ROCCA;
Cirugia;Cirugía General;99;0;99;95;1;96;0;96;3739;2163;1022;591;5785;2253;94;104;2016;2113;HOSPITAL DE REHABILITACION M. ROCCA;
Cirugia;Subtotal Cirugia;99;0;99;95;1;96;0;96;3739;2163;1022;591;5785;2253;94;104;2016;2113;HOSPITAL DE REHABILITACION M. ROCCA;
Cirugia;Total Hospital;188;0;188;176;3;179;0;179;27181;19859;7427;5426;7306;11094;241;168;2016;2113;HOSPITAL DE REHABILITACION M. ROCCA;
Medicina;Fisiatría;96;5;101;87;0;87;5;92;14640;7170;40;1959;4898;7793;23;0;2016;2114;INSTITUTO DE REHABILITACION PSICOFISICA (I.R.E.P.);
Medicina;Subtotal Medicina;96;5;101;87;0;87;5;92;14640;7170;40;1959;4898;7793;23;0;2016;2114;INSTITUTO DE REHABILITACION PSICOFISICA (I.R.E.P.);
Cirugia;Cirugía General;404;25;429;405;0;405;25;430;12161;5262;3323;1438;4327;1224;1294;0;2016;2114;INSTITUTO DE REHABILITACION PSICOFISICA (I.R.E.P.);
Cirugia;Subtotal Cirugia;404;25;429;405;0;405;25;430;12161;5262;3323;1438;4327;1224;1294;0;2016;2114;INSTITUTO DE REHABILITACION PSICOFISICA (I.R.E.P.);
Cirugia;Total Hospital;500;30;530;492;0;492;30;522;26801;12432;7323;3397;4639;2527;672;0;2016;2114;INSTITUTO DE REHABILITACION PSICOFISICA (I.R.E.P.);
Medicina;Terapia Prolongada;632;45;677;575;17;592;85;677;2923;2552;799;697;8731;377;8477;251;2016;2115;HOSPITAL DE REHABILITACION RESPIRATORIA MARIA FERRER;
Medicina;Terapia Intermedia;727;267;994;840;30;870;123;993;7654;6152;2091;1681;8038;62;4748;302;2016;2115;HOSPITAL DE REHABILITACION RESPIRATORIA MARIA FERRER;
Medicina;Subtotal Medicina;1359;312;1671;1415;47;1462;208;1670;10577;8704;289;2378;8229;521;5779;281;2016;2115;HOSPITAL DE REHABILITACION RESPIRATORIA MARIA FERRER;
Urgencia;Terapia Intensiva;198;138;336;38;56;94;242;336;2914;2409;796;658;8267;717;422;1667;2016;2115;HOSPITAL DE REHABILITACION RESPIRATORIA MARIA FERRER;
Urgencia;Subtotal Urgencia;198;138;336;38;56;94;242;336;2914;2409;796;658;8267;717;422;1667;2016;2115;HOSPITAL DE REHABILITACION RESPIRATORIA MARIA FERRER;
Urgencia;Total Hospital;1557;450;2007;1453;103;1556;450;2006;13491;11113;3686;3036;8237;714;4221;662;2016;2115;HOSPITAL DE REHABILITACION RESPIRATORIA MARIA FERRER;
Medicina;Cardiología;5;169;174;111;7;118;58;176;3000;1269;822;348;423;721;2141;398;2017;2126;HOSPITAL GENERAL DE AGUDOS DR. T. ALVAREZ;
Medicina;Clínica Médica;195;1113;1308;951;165;1116;191;1307;23676;18238;6487;4997;7703;1395;2015;1262;2017;2126;HOSPITAL GENERAL DE AGUDOS DR. T. ALVAREZ;
Medicina;Neurología;2;24;26;15;5;20;5;25;368;290;101;79;788;116;248;20;2017;2126;HOSPITAL GENERAL DE AGUDOS DR. T. ALVAREZ;
Medicina;Psicopatologia Y Salud Mental;2;31;33;39;0;39;4;43;7728;5339;2117;1463;6909;12416;203;0;2017;2126;HOSPITAL GENERAL DE AGUDOS DR. T. ALVAREZ;
Medicina;Unidad Coronaria;19;184;203;91;18;109;95;204;1800;1140;493;312;6333;559;4137;882;2017;2126;HOSPITAL GENERAL DE AGUDOS DR. T. ALVAREZ;
Medicina;Subtotal Medicina;223;1521;1744;1207;195;1402;353;1755;36572;26276;1002;7199;7185;1497;1752;1111;2017;2126;HOSPITAL GENERAL DE AGUDOS DR. T. ALVAREZ;
Cirugia;Cirugía General;542;688;1230;1057;15;1072;166;1238;11777;8149;3227;2233;6919;658;3837;121;2017;2126;HOSPITAL GENERAL DE AGUDOS DR. T. ALVAREZ;
Cirugia;Ginecología;128;42;170;163;1;164;10;174;1349;958;37;262;7102;551;4708;57;2017;2126;HOSPITAL GENERAL DE AGUDOS DR. T. ALVAREZ;
Cirugia;Ortopedia Y Traumatología;195;184;379;305;3;308;72;380;7414;4301;2031;1178;5801;1132;1871;79;2017;2126;HOSPITAL GENERAL DE AGUDOS DR. T. ALVAREZ;
Cirugia;Urología;67;20;87;73;0;73;14;87;748;478;205;131;639;549;4245;0;2017;2126;HOSPITAL GENERAL DE AGUDOS DR. T. ALVAREZ;
Cirugia;Subtotal Cirugia;932;934;1866;1598;19;1617;262;1879;21288;13886;5832;3804;6523;739;3222;101;2017;2126;HOSPITAL GENERAL DE AGUDOS DR. T. ALVAREZ;
Pediatria;Recien Nacido Sano;964;104;1068;984;0;984;80;1064;6855;2238;1878;613;3265;21;5665;0;2017;2126;HOSPITAL GENERAL DE AGUDOS DR. T. ALVAREZ;
Pediatria;Neonatología;227;80;307;210;1;211;105;316;3073;1372;842;376;4465;434;3753;32;2017;2126;HOSPITAL GENERAL DE AGUDOS DR. T. ALVAREZ;
Pediatria;Pediatría;1141;1;1142;1135;0;1135;1;1136;9200;2778;2521;761;302;245;4507;0;2017;2126;HOSPITAL GENERAL DE AGUDOS DR. T. ALVAREZ;
Pediatria;Subtotal Pediatria;2332;185;2517;2329;1;2330;186;2516;19128;6388;5241;175;334;254;4801;4;2017;2126;HOSPITAL GENERAL DE AGUDOS DR. T. ALVAREZ;
Cirugia;Cirugía Cardiovascular;47;14;61;49;2;51;10;61;1473;242;402;66;1643;397;1516;328;2016;2119;HOSPITAL GENERAL DE AGUDOS B. RIVADAVIA;
Cirugia;Ginecología;561;2;563;554;2;556;7;563;5856;1563;16;427;2669;278;3519;36;2016;2119;HOSPITAL GENERAL DE AGUDOS B. RIVADAVIA;
Cirugia;Neurocirugía;139;32;171;149;2;151;20;171;1821;903;498;247;4959;528;3437;117;2016;2119;HOSPITAL GENERAL DE AGUDOS B. RIVADAVIA;
Cirugia;Ortopedia Y Traumatología;260;14;274;248;7;255;18;273;4980;3402;1361;93;6831;1246;2006;256;2016;2119;HOSPITAL GENERAL DE AGUDOS B. RIVADAVIA;
Cirugia;Otorrinolaringología;187;1;188;187;0;187;1;188;2474;359;676;98;1451;191;2781;0;2016;2119;HOSPITAL GENERAL DE AGUDOS B. RIVADAVIA;
Cirugia;Urología;276;10;286;271;1;272;14;286;4392;1314;12;359;2992;459;2383;35;2016;2119;HOSPITAL GENERAL DE AGUDOS B. RIVADAVIA;
Cirugia;Subtotal Cirugia;2123;129;2252;2104;23;2127;120;2247;34891;12361;9533;3377;3543;55;2357;102;2016;2119;HOSPITAL GENERAL DE AGUDOS B. RIVADAVIA;
Pediatria;Recien Nacido Sano;837;191;1028;966;0;966;59;1025;3498;3498;956;956;100;341;10725;0;2016;2119;HOSPITAL GENERAL DE AGUDOS B. RIVADAVIA;
Pediatria;Neonatología;304;60;364;165;5;170;195;365;7321;4213;20;1151;5755;1154;1825;137;2016;2119;HOSPITAL GENERAL DE AGUDOS B. RIVADAVIA;
Pediatria;Pediatría;562;4;566;564;0;564;2;566;6191;2254;1692;616;3641;398;3346;0;2016;2119;HOSPITAL GENERAL DE AGUDOS B. RIVADAVIA;
Pediatria;Subtotal Pediatria;1703;255;1958;1695;5;1700;256;1956;17010;9965;4648;2723;5858;509;4209;26;2016;2119;HOSPITAL GENERAL DE AGUDOS B. RIVADAVIA;
Tocoginecologia;Obstetricia;1482;7;1489;1490;0;1490;4;1494;10443;8617;2853;2354;8251;577;5236;0;2016;2119;HOSPITAL GENERAL DE AGUDOS B. RIVADAVIA;
Tocoginecologia;Subtotal Tocoginecologia;1482;7;1489;1490;0;1490;4;1494;10443;8617;2853;2354;8251;577;5236;0;2016;2119;HOSPITAL GENERAL DE AGUDOS B. RIVADAVIA;
Urgencia;Coordinacion Cuidados Intensivos;116;147;263;11;89;100;162;262;3142;2492;858;681;7931;951;3052;3397;2016;2119;HOSPITAL GENERAL DE AGUDOS B. RIVADAVIA;
Urgencia;Subtotal Urgencia;116;147;263;11;89;100;162;262;3142;2492;858;681;7931;951;3052;3397;2016;2119;HOSPITAL GENERAL DE AGUDOS B. RIVADAVIA;
Urgencia;Total Hospital;6596;875;7471;6346;247;6593;875;7468;98304;52861;26859;14443;5377;802;2455;375;2016;2119;HOSPITAL GENERAL DE AGUDOS B. RIVADAVIA;
Medicina;Cardiología;227;257;484;403;5;408;78;486;4388;2048;1199;56;4667;421;4054;103;2016;2121;HOSPITAL GENERAL DE AGUDOS DONACION F. SANTOJANNI;
Medicina;Clínica Médica;760;201;961;650;184;834;137;971;24012;23015;6561;6288;9585;237;148;1895;2016;2121;HOSPITAL GENERAL DE AGUDOS DONACION F. SANTOJANNI;
Medicina;Unidad Coronaria;597;136;733;360;48;408;327;735;2928;2131;8;582;7278;29;9188;653;2016;2121;HOSPITAL GENERAL DE AGUDOS DONACION F. SANTOJANNI;
Medicina;Subtotal Medicina;1584;594;2178;1413;237;1650;542;2192;31328;27194;856;743;868;1241;2561;1081;2016;2121;HOSPITAL GENERAL DE AGUDOS DONACION F. SANTOJANNI;
Cirugia;Cirugía General;982;156;1138;1051;19;1070;63;1133;10404;7963;2843;2176;7654;703;3986;168;2016;2121;HOSPITAL GENERAL DE AGUDOS DONACION F. SANTOJANNI;
Cirugia;Cirugía Cardiovascular;34;1;35;35;0;35;0;35;714;35;195;1;49;1;1794;0;2016;2121;HOSPITAL GENERAL DE AGUDOS DONACION F. SANTOJANNI;
Cirugia;Microcirugia Y Cirugia Reparadora;441;4;445;444;0;444;1;445;1729;678;472;185;3921;152;942;0;2016;2121;HOSPITAL GENERAL DE AGUDOS DONACION F. SANTOJANNI;
Cirugia;Ginecología;426;46;472;448;3;451;21;472;4954;3427;1354;936;6918;726;3487;64;2016;2121;HOSPITAL GENERAL DE AGUDOS DONACION F. SANTOJANNI;
Cirugia;Neurocirugía;164;73;237;190;3;193;43;236;4474;3999;1222;1093;8938;1694;1931;127;2016;2121;HOSPITAL GENERAL DE AGUDOS DONACION F. SANTOJANNI;
Cirugia;Ortopedia Y Traumatología;548;41;589;533;23;556;33;589;10091;9696;2757;2649;9609;1646;2136;39;2016;2121;HOSPITAL GENERAL DE AGUDOS DONACION F. SANTOJANNI;
Cirugia;Otorrinolaringología;35;0;35;35;0;35;0;35;76;45;21;12;5921;129;16855;0;2016;2121;HOSPITAL GENERAL DE AGUDOS DONACION F. SANTOJANNI;
Cirugia;Urología;262;15;277;269;0;269;8;277;1914;1398;523;382;7304;505;5297;0;2016;2121;HOSPITAL GENERAL DE AGUDOS DONACION F. SANTOJANNI;
Cirugia;Subtotal Cirugia;2892;336;3228;3005;48;3053;169;3222;34356;27241;9387;7443;7929;845;3432;149;2016;2121;HOSPITAL GENERAL DE AGUDOS DONACION F. SANTOJANNI;
Pediatria;Recien Nacido Sano;2331;160;2491;2446;0;2446;55;2501;21960;10824;60;2957;4929;433;4168;0;2016;2121;HOSPITAL GENERAL DE AGUDOS DONACION F. SANTOJANNI;
Pediatria;Neonatología;335;183;518;203;19;222;289;511;10980;5713;30;1561;5203;1118;1703;372;2016;2121;HOSPITAL GENERAL DE AGUDOS DONACION F. SANTOJANNI;
Pediatria;Pediatría;825;1;826;825;0;825;1;826;8959;3991;2448;109;4455;483;3374;0;2016;2121;HOSPITAL GENERAL DE AGUDOS DONACION F. SANTOJANNI;
Pediatria;Subtotal Pediatria;3491;344;3835;3474;19;3493;345;3838;41899;20528;11448;5609;4899;535;3353;5;2016;2121;HOSPITAL GENERAL DE AGUDOS DONACION F. SANTOJANNI;
Tocoginecologia;Obstetricia;2847;7;2854;2856;0;2856;1;2857;21960;15785;60;4313;7188;553;4762;0;2016;2121;HOSPITAL GENERAL DE AGUDOS DONACION F. SANTOJANNI;
Tocoginecologia;Subtotal Tocoginecologia;2847;7;2854;2856;0;2856;1;2857;21960;15785;60;4313;7188;553;4762;0;2016;2121;HOSPITAL GENERAL DE AGUDOS DONACION F. SANTOJANNI;
Urgencia;Terapia Intermedia;7;53;60;3;4;7;53;60;2928;580;8;158;1981;967;75;667;2016;2121;HOSPITAL GENERAL DE AGUDOS DONACION F. SANTOJANNI;
Urgencia;Terapia Intensiva;54;195;249;4;83;87;163;250;4391;2967;12;811;6757;1187;2084;332;2016;2121;HOSPITAL GENERAL DE AGUDOS DONACION F. SANTOJANNI;
Urgencia;Observación ;548;44;592;44;244;288;300;588;2928;2158;8;59;737;367;735;415;2016;2121;HOSPITAL GENERAL DE AGUDOS DONACION F. SANTOJANNI;
Urgencia;Subtotal Urgencia;609;292;901;51;331;382;516;898;10247;5705;28;1559;5567;635;3207;3686;2016;2121;HOSPITAL GENERAL DE AGUDOS DONACION F. SANTOJANNI;
Urgencia;Total Hospital;11423;1573;12996;10799;635;11434;1573;13007;139790;96453;38194;26353;69;844;2994;555;2016;2121;HOSPITAL GENERAL DE AGUDOS DONACION F. SANTOJANNI;
Medicina;Cuidados Paliativos;122;40;162;89;71;160;4;164;1206;1058;33;289;8773;645;4977;4329;2016;2124;HOSPITAL GENERAL DE AGUDOS DR. E. TORNU;
Medicina;Clínica Médica;77;858;935;679;108;787;158;945;17004;14764;4646;4034;8683;1562;2034;1143;2016;2124;HOSPITAL GENERAL DE AGUDOS DR. E. TORNU;
Medicina;Neumotisiología;85;426;511;376;33;409;104;513;15372;5519;42;1508;359;1076;1221;643;2016;2124;HOSPITAL GENERAL DE AGUDOS DR. E. TORNU;
Medicina;Subtotal Medicina;284;1324;1608;1144;212;1356;266;1622;33582;21341;9175;5831;6355;1316;1768;1307;2016;2124;HOSPITAL GENERAL DE AGUDOS DR. E. TORNU;
Cirugia;Cirugía General;507;404;911;832;6;838;63;901;8758;4616;2393;1261;5271;512;3765;67;2016;2124;HOSPITAL GENERAL DE AGUDOS DR. E. TORNU;
Cirugia;Cirugía Toracica;62;33;95;75;2;77;19;96;2138;453;584;124;2119;472;1643;208;2016;2124;HOSPITAL GENERAL DE AGUDOS DR. E. TORNU;
Cirugia;Ginecología;183;14;197;190;0;190;7;197;627;625;171;171;9968;317;115;0;2016;2124;HOSPITAL GENERAL DE AGUDOS DR. E. TORNU;
Cirugia;Ortopedia Y Traumatología;34;135;169;137;0;137;31;168;4430;2813;121;769;635;1674;1388;0;2016;2124;HOSPITAL GENERAL DE AGUDOS DR. E. TORNU;
Cirugia;Urología;218;33;251;231;0;231;20;251;883;881;241;241;9977;351;10404;0;2016;2124;HOSPITAL GENERAL DE AGUDOS DR. E. TORNU;
Cirugia;Subtotal Cirugia;1004;619;1623;1465;8;1473;140;1613;16836;9388;46;2565;5576;582;3507;5;2016;2124;HOSPITAL GENERAL DE AGUDOS DR. E. TORNU;
Urgencia;Terapia Intermedia;13;258;271;97;36;133;140;273;2936;2761;802;754;9404;1011;3403;1319;2016;2124;HOSPITAL GENERAL DE AGUDOS DR. E. TORNU;
Urgencia;Guardia Del Día;3122;63;3185;1263;108;1371;1811;3182;2354;2728;643;745;11589;86;49474;339;2016;2124;HOSPITAL GENERAL DE AGUDOS DR. E. TORNU;
Urgencia;Terapia Intensiva;3;207;210;18;79;97;114;211;2954;2805;807;766;9496;1329;2614;3744;2016;2124;HOSPITAL GENERAL DE AGUDOS DR. E. TORNU;
Urgencia;Subtotal Urgencia;3138;528;3666;1378;223;1601;2065;3666;8244;8294;2252;2266;10061;226;16276;608;2016;2124;HOSPITAL GENERAL DE AGUDOS DR. E. TORNU;
Urgencia;Total Hospital;4426;2471;6897;3987;443;4430;2471;6901;58662;39023;16028;10662;6652;881;2764;10;2016;2124;HOSPITAL GENERAL DE AGUDOS DR. E. TORNU;
Medicina;Cardiología;76;28;104;89;5;94;9;103;884;685;242;187;7749;665;4264;485;2016;2120;HOSPITAL GENERAL DE AGUDOS D. VELEZ SARSFIELD;
Medicina;Clínica Médica;406;47;453;326;75;401;55;456;5557;4834;1518;1321;8699;106;3003;1645;2016;2120;HOSPITAL GENERAL DE AGUDOS D. VELEZ SARSFIELD;
Medicina;Subtotal Medicina;482;75;557;415;80;495;64;559;6441;5519;176;1508;8569;987;3176;1431;2016;2120;HOSPITAL GENERAL DE AGUDOS D. VELEZ SARSFIELD;
Cirugia;Cirugía General;739;47;786;726;16;742;39;781;4615;3343;1261;913;7244;428;6194;205;2016;2120;HOSPITAL GENERAL DE AGUDOS D. VELEZ SARSFIELD;
Cirugia;Ginecología;106;13;119;117;0;117;2;119;742;310;203;85;4178;261;587;0;2016;2120;HOSPITAL GENERAL DE AGUDOS D. VELEZ SARSFIELD;
Cirugia;Oftalmología;0;0;0;0;0;0;0;0;385;0;105;0;0;0;;;2016;2120;HOSPITAL GENERAL DE AGUDOS D. VELEZ SARSFIELD;
Cirugia;Ortopedia Y Traumatología;237;16;253;242;6;248;17;265;3279;2983;896;815;9097;1126;2958;226;2016;2120;HOSPITAL GENERAL DE AGUDOS D. VELEZ SARSFIELD;
Cirugia;Subtotal Cirugia;1082;76;1158;1085;22;1107;58;1165;9021;6636;2465;1813;7356;57;4727;189;2016;2120;HOSPITAL GENERAL DE AGUDOS D. VELEZ SARSFIELD;
Pediatria;Recien Nacido Sano;705;230;935;849;0;849;89;938;6866;2523;1876;689;3675;269;50;0;2016;2120;HOSPITAL GENERAL DE AGUDOS D. VELEZ SARSFIELD;
Pediatria;Neonatología;490;89;579;344;3;347;231;578;3009;2042;822;558;6786;353;7031;52;2016;2120;HOSPITAL GENERAL DE AGUDOS D. VELEZ SARSFIELD;
Pediatria;Pediatría;543;6;549;548;1;549;3;552;5027;1819;1373;497;3618;33;4019;18;2016;2120;HOSPITAL GENERAL DE AGUDOS D. VELEZ SARSFIELD;
Pediatria;Subtotal Pediatria;1738;325;2063;1741;4;1745;323;2068;14902;6384;4072;1744;4284;309;5079;19;2016;2120;HOSPITAL GENERAL DE AGUDOS D. VELEZ SARSFIELD;
Tocoginecologia;Obstetricia;1403;2;1405;1387;0;1387;16;1403;8813;4453;2408;1217;5053;317;5827;0;2016;2120;HOSPITAL GENERAL DE AGUDOS D. VELEZ SARSFIELD;
Tocoginecologia;Subtotal Tocoginecologia;1403;2;1405;1387;0;1387;16;1403;8813;4453;2408;1217;5053;317;5827;0;2016;2120;HOSPITAL GENERAL DE AGUDOS D. VELEZ SARSFIELD;
Urgencia;Terapia Intermedia;6;3;9;0;6;6;3;9;210;206;57;56;981;2289;1569;6667;2016;2120;HOSPITAL GENERAL DE AGUDOS D. VELEZ SARSFIELD;
Urgencia;Terapia Intensiva;80;65;145;8;54;62;82;144;2313;2151;632;588;93;1494;2279;375;2016;2120;HOSPITAL GENERAL DE AGUDOS D. VELEZ SARSFIELD;
Urgencia;Subtotal Urgencia;86;68;154;8;60;68;85;153;2523;2357;689;644;9342;1541;222;3922;2016;2120;HOSPITAL GENERAL DE AGUDOS D. VELEZ SARSFIELD;
Urgencia;Total Hospital;4791;546;5337;4636;166;4802;546;5348;41700;25349;11393;6926;6079;528;4215;346;2016;2120;HOSPITAL GENERAL DE AGUDOS D. VELEZ SARSFIELD;
Medicina;Unidad Coronaria;44;128;172;97;12;109;67;176;1830;1411;5;386;771;802;352;682;2016;2118;HOSPITAL GENERAL DE AGUDOS A. ZUBIZARRETA;
Medicina;Subtotal Medicina;44;128;172;97;12;109;67;176;1830;1411;5;386;771;802;352;682;2016;2118;HOSPITAL GENERAL DE AGUDOS A. ZUBIZARRETA;
Pediatria;Adolescencia;110;2;112;88;0;88;0;88;2235;955;611;261;4273;1085;1441;0;2016;2118;HOSPITAL GENERAL DE AGUDOS A. ZUBIZARRETA;
Pediatria;Pediatría;433;12;445;460;0;460;12;472;4353;3879;1189;106;8911;822;3969;0;2016;2118;HOSPITAL GENERAL DE AGUDOS A. ZUBIZARRETA;
Pediatria;Subtotal Pediatria;543;14;557;548;0;548;12;560;6588;4834;18;1321;7338;863;3111;0;2016;2118;HOSPITAL GENERAL DE AGUDOS A. ZUBIZARRETA;
Urgencia;Terapia Intermedia;1108;493;1601;1407;33;1440;167;1607;10740;6478;2934;177;6032;403;5476;205;2016;2118;HOSPITAL GENERAL DE AGUDOS A. ZUBIZARRETA;
Urgencia;Terapia Intensiva;49;162;211;13;58;71;142;213;2166;1955;592;534;9026;918;3599;2723;2016;2118;HOSPITAL GENERAL DE AGUDOS A. ZUBIZARRETA;
Urgencia;Subtotal Urgencia;1157;655;1812;1420;91;1511;309;1820;12906;8433;3526;2304;6534;463;5161;5;2016;2118;HOSPITAL GENERAL DE AGUDOS A. ZUBIZARRETA;
Area Indiferenciada;Area Indiferenciada - Cuidados Alejados;1779;581;2360;1186;175;1361;990;2351;17078;13209;4666;3609;7735;562;5038;744;2016;2118;HOSPITAL GENERAL DE AGUDOS A. ZUBIZARRETA;
Area Indiferenciada;Subtotal Area Indiferenciada;1779;581;2360;1186;175;1361;990;2351;17078;13209;4666;3609;7735;562;5038;744;2016;2118;HOSPITAL GENERAL DE AGUDOS A. ZUBIZARRETA;
Area Indiferenciada;Total Hospital;3523;1378;4901;3251;278;3529;1378;4907;38402;27887;10492;7619;7262;79;3363;788;2016;2118;HOSPITAL GENERAL DE AGUDOS A. ZUBIZARRETA;
Medicina;Psicopatologia Y Salud Mental;32;7;39;30;0;30;4;34;2852;2014;779;55;7062;5924;436;0;2016;2172;HOSPITAL GENERAL DE NIÑOS PEDRO DE ELIZALDE;
Medicina;Subtotal Medicina;32;7;39;30;0;30;4;34;2852;2014;779;55;7062;5924;436;0;2016;2172;HOSPITAL GENERAL DE NIÑOS PEDRO DE ELIZALDE;
Cuidados Genereales - Area Indiferenciada;Sector 1;496;454;950;908;0;908;44;952;8479;7247;2317;198;8547;761;4109;0;2016;2172;HOSPITAL GENERAL DE NIÑOS PEDRO DE ELIZALDE;
Cuidados Genereales - Area Indiferenciada;Sector 2;645;273;918;867;0;867;58;925;7897;6478;2158;177;8203;7;4287;0;2016;2172;HOSPITAL GENERAL DE NIÑOS PEDRO DE ELIZALDE;
Cuidados Genereales - Area Indiferenciada;Sector 3 A;233;154;387;352;0;352;34;386;3512;2879;96;787;8198;746;4023;0;2016;2172;HOSPITAL GENERAL DE NIÑOS PEDRO DE ELIZALDE;
Cuidados Genereales - Area Indiferenciada;Sector 3 B - Presión Negativa;222;130;352;295;0;295;60;355;4661;3432;1273;938;7363;967;2788;0;2016;2172;HOSPITAL GENERAL DE NIÑOS PEDRO DE ELIZALDE;
Cuidados Genereales - Area Indiferenciada;Sector 4;703;313;1016;964;1;965;47;1012;8344;6897;228;1884;8266;682;4439;1;2016;2172;HOSPITAL GENERAL DE NIÑOS PEDRO DE ELIZALDE;
Cuidados Genereales - Area Indiferenciada;Sector 5;573;355;928;867;1;868;66;934;8265;6684;2258;1826;8087;716;4136;11;2016;2172;HOSPITAL GENERAL DE NIÑOS PEDRO DE ELIZALDE;
Cuidados Genereales - Area Indiferenciada;Sector 6 A;480;118;598;528;2;530;70;600;4471;3023;1222;826;6761;504;4912;33;2016;2172;HOSPITAL GENERAL DE NIÑOS PEDRO DE ELIZALDE;
Cuidados Genereales - Area Indiferenciada;Sector 6 B - Presión Positiva;189;50;239;183;2;185;46;231;3019;1639;825;448;5429;71;28;87;2016;2172;HOSPITAL GENERAL DE NIÑOS PEDRO DE ELIZALDE;
Cuidados Genereales - Area Indiferenciada;Sector 7;1707;199;1906;1778;0;1778;131;1909;9704;6346;2651;1734;654;332;72;0;2016;2172;HOSPITAL GENERAL DE NIÑOS PEDRO DE ELIZALDE;
Cuidados Especiales;Neonatología Alta Complejidad;83;25;108;12;19;31;75;106;4217;2499;1152;683;5926;2358;92;1792;2016;2172;HOSPITAL GENERAL DE NIÑOS PEDRO DE ELIZALDE;
Cuidados Especiales;Neonatología Mediana Complejidad;167;78;245;208;4;212;27;239;4375;3199;1195;874;7312;1338;1999;167;2016;2172;HOSPITAL GENERAL DE NIÑOS PEDRO DE ELIZALDE;
Cuidados Especiales;Cuidados Intermedios;93;167;260;71;2;73;185;258;2852;1776;779;485;6227;688;3311;78;2016;2172;HOSPITAL GENERAL DE NIÑOS PEDRO DE ELIZALDE;
Cuidados Especiales;Cuidados Intensivos;112;191;303;5;23;28;276;304;3870;2327;1057;636;6013;765;2875;757;2016;2172;HOSPITAL GENERAL DE NIÑOS PEDRO DE ELIZALDE;
Cuidados Especiales;Cirugía Cardiovascular;93;25;118;96;10;106;12;118;2807;1503;767;411;5354;1274;1539;847;2016;2172;HOSPITAL GENERAL DE NIÑOS PEDRO DE ELIZALDE;
Cuidados Especiales;Guardia;2715;0;2715;1311;1;1312;1404;2716;3053;2977;834;813;9751;11;3256;4;2016;2172;HOSPITAL GENERAL DE NIÑOS PEDRO DE ELIZALDE;
Cuidados Especiales;Subtotal Cuidados Especiales;3263;486;3749;1703;59;1762;1979;3741;21174;14281;5785;3902;6745;382;6466;158;2016;2172;HOSPITAL GENERAL DE NIÑOS PEDRO DE ELIZALDE;
Cuidados Especiales;Total Hospital;8543;2539;11082;8475;65;8540;2539;11079;82378;60920;22508;16645;7395;713;3794;76;2016;2172;HOSPITAL GENERAL DE NIÑOS PEDRO DE ELIZALDE;
Medicina;Pediatria;3256;572;3828;3256;11;3267;506;3773;35546;29878;9712;8163;8405;792;3885;29;2016;2164;HOSPITAL GENERAL DE NIÑOS RICARDO GUTIERREZ;
Medicina;Endocrinología;273;0;273;273;0;273;0;273;2088;271;57;74;1298;99;4785;0;2016;2164;HOSPITAL GENERAL DE NIÑOS RICARDO GUTIERREZ;
Medicina;Infecciosas;600;194;794;636;11;647;144;791;9149;8780;25;2399;9597;111;3164;139;2016;2164;HOSPITAL GENERAL DE NIÑOS RICARDO GUTIERREZ;
Medicina;Neonatología;258;18;276;235;12;247;30;277;6634;5911;1813;1615;891;2134;1528;433;2016;2164;HOSPITAL GENERAL DE NIÑOS RICARDO GUTIERREZ;
Medicina;Centro Respiratorio;258;128;386;246;2;248;136;384;4416;3914;1207;1069;8863;1019;3183;52;2016;2164;HOSPITAL GENERAL DE NIÑOS RICARDO GUTIERREZ;
Medicina;Nefrología;373;21;394;384;1;385;12;397;4056;2134;1108;583;5261;538;3582;25;2016;2164;HOSPITAL GENERAL DE NIÑOS RICARDO GUTIERREZ;
Medicina;Subtotal Medicina;5018;933;5951;5030;37;5067;828;5895;61889;50888;1691;13904;8222;863;3486;63;2016;2164;HOSPITAL GENERAL DE NIÑOS RICARDO GUTIERREZ;
Cirugia;Cirugía General;1695;188;1883;1694;0;1694;191;1885;9524;6271;2602;1713;6584;333;7244;0;2016;2164;HOSPITAL GENERAL DE NIÑOS RICARDO GUTIERREZ;
Cirugia;Cirugía Cardiovascular;308;35;343;308;16;324;19;343;8418;4772;23;1304;5669;1391;1491;466;2016;2164;HOSPITAL GENERAL DE NIÑOS RICARDO GUTIERREZ;
Cirugia;Cirugía Plástica Y Reparadora - niÃ±os;555;26;581;538;0;538;43;581;3302;1569;902;429;4752;27;644;0;2016;2164;HOSPITAL GENERAL DE NIÑOS RICARDO GUTIERREZ;
Cirugia;Neurocirugía;400;101;501;387;9;396;106;502;8083;3482;2208;951;4308;694;2273;179;2016;2164;HOSPITAL GENERAL DE NIÑOS RICARDO GUTIERREZ;
Cirugia;Ortopedia Y Traumatología;1334;140;1474;1332;0;1332;136;1468;11687;5950;3193;1626;5091;405;4597;0;2016;2164;HOSPITAL GENERAL DE NIÑOS RICARDO GUTIERREZ;
Cirugia;Urologia;304;7;311;301;0;301;11;312;4421;1422;1208;389;3216;456;2583;0;2016;2164;HOSPITAL GENERAL DE NIÑOS RICARDO GUTIERREZ;
Cirugia;Subtotal Cirugia;4596;497;5093;4560;25;4585;506;5091;45435;23466;12414;6411;5165;461;4101;49;2016;2164;HOSPITAL GENERAL DE NIÑOS RICARDO GUTIERREZ;
Urgencia;Terapia Intermedia;66;474;540;22;1;23;518;541;2922;2388;798;652;8172;441;6776;18;2016;2164;HOSPITAL GENERAL DE NIÑOS RICARDO GUTIERREZ;
Urgencia;Terapia Intensiva;100;204;304;3;48;51;256;307;5851;4802;1599;1312;8207;1564;192;1564;2016;2164;HOSPITAL GENERAL DE NIÑOS RICARDO GUTIERREZ;
Urgencia;Subtotal Urgencia;166;678;844;25;49;74;774;848;8773;7190;2397;1964;8196;848;3538;578;2016;2164;HOSPITAL GENERAL DE NIÑOS RICARDO GUTIERREZ;
Urgencia;Total Hospital;9780;2108;11888;9615;111;9726;2108;11834;116097;81544;3172;2228;7024;838;3066;114;2016;2164;HOSPITAL GENERAL DE NIÑOS RICARDO GUTIERREZ;
Pediatria;Recien Nacido Sano;4420;377;4797;4376;0;4376;418;4794;25254;14389;69;3931;5698;3;6948;0;2016;2167;HOSPITAL MATERNO INFANTIL R. SARDA;
Pediatria;Neonatología;1044;949;1993;1002;88;1090;908;1998;29646;17196;81;4698;58;861;2467;44;2016;2167;HOSPITAL MATERNO INFANTIL R. SARDA;
Pediatria;Subtotal Pediatria;5464;1326;6790;5378;88;5466;1326;6792;54900;31585;150;863;5753;465;4528;13;2016;2167;HOSPITAL MATERNO INFANTIL R. SARDA;
Tocoginecologia;Tocoginecología;6585;141;6726;6632;0;6632;85;6717;35258;27046;9633;739;7671;403;6973;0;2016;2167;HOSPITAL MATERNO INFANTIL R. SARDA;
Tocoginecologia;Subtotal Tocoginecologia;6585;141;6726;6632;0;6632;85;6717;35258;27046;9633;739;7671;403;6973;0;2016;2167;HOSPITAL MATERNO INFANTIL R. SARDA;
Urgencia;Terapia Intensiva;64;33;97;8;0;8;89;97;730;322;199;88;4411;332;4863;0;2016;2167;HOSPITAL MATERNO INFANTIL R. SARDA;
Urgencia;Subtotal Urgencia;64;33;97;8;0;8;89;97;730;322;199;88;4411;332;4863;0;2016;2167;HOSPITAL MATERNO INFANTIL R. SARDA;
Urgencia;Total Hospital;12113;1500;13613;12018;88;12106;1500;13606;90888;58953;24833;16107;6486;487;4875;73;2016;2167;HOSPITAL MATERNO INFANTIL R. SARDA;
Medicina;Dermatología;362;21;383;330;2;332;58;390;12341;8123;3372;2219;6582;2083;1157;51;2016;2110;HOSPITAL DE INFECCIOSAS F. MUÑIZ;
Medicina;Infecciosas;1523;276;1799;1487;84;1571;232;1803;42032;30391;11484;8304;723;1686;157;466;2016;2110;HOSPITAL DE INFECCIOSAS F. MUÑIZ;
Urgencia;Subtotal Urgencia;2738;443;3181;1241;226;1467;1710;3177;8514;8506;2333;233;9991;268;1362;711;2017;2124;HOSPITAL GENERAL DE AGUDOS DR. E. TORNU;
Urgencia;Total Hospital;4023;2029;6052;3575;438;4013;2029;6042;53671;36467;14704;9991;6795;909;2729;1091;2017;2124;HOSPITAL GENERAL DE AGUDOS DR. E. TORNU;
Medicina;Cardiología;65;26;91;76;3;79;13;92;837;634;229;174;7575;689;4012;326;2017;2120;HOSPITAL GENERAL DE AGUDOS D. VELEZ SARSFIELD;
Medicina;Clínica Médica;465;62;527;380;94;474;47;521;5987;5442;164;1491;909;1045;3176;1804;2017;2120;HOSPITAL GENERAL DE AGUDOS D. VELEZ SARSFIELD;
Medicina;Subtotal Medicina;530;88;618;456;97;553;60;613;6824;6076;187;1665;8904;991;3279;1582;2017;2120;HOSPITAL GENERAL DE AGUDOS D. VELEZ SARSFIELD;
Cirugia;Cirugía General;634;36;670;633;8;641;35;676;4410;2622;1208;718;5946;388;5595;118;2017;2120;HOSPITAL GENERAL DE AGUDOS D. VELEZ SARSFIELD;
Cirugia;Ginecología;142;18;160;158;1;159;1;160;787;454;216;124;5769;284;7421;63;2017;2120;HOSPITAL GENERAL DE AGUDOS D. VELEZ SARSFIELD;
Cirugia;Oftalmología;0;0;0;0;0;0;0;0;319;0;87;0;0;0;;;2017;2120;HOSPITAL GENERAL DE AGUDOS D. VELEZ SARSFIELD;
Cirugia;Ortopedia Y Traumatología;227;13;240;209;9;218;18;236;3247;2907;89;796;8953;1232;2653;381;2017;2120;HOSPITAL GENERAL DE AGUDOS D. VELEZ SARSFIELD;
Cirugia;Subtotal Cirugia;1003;67;1070;1000;18;1018;54;1072;8763;5983;2401;1639;6828;558;4465;168;2017;2120;HOSPITAL GENERAL DE AGUDOS D. VELEZ SARSFIELD;
Pediatria;Recien Nacido Sano;659;309;968;860;0;860;113;973;6814;2781;1867;762;4081;286;5212;0;2017;2120;HOSPITAL GENERAL DE AGUDOS D. VELEZ SARSFIELD;
Pediatria;Neonatología;564;112;676;361;2;363;308;671;3041;2306;833;632;7583;344;8054;3;2017;2120;HOSPITAL GENERAL DE AGUDOS D. VELEZ SARSFIELD;
Pediatria;Pediatría;542;15;557;548;1;549;4;553;4835;1920;1325;526;3971;347;4175;18;2017;2120;HOSPITAL GENERAL DE AGUDOS D. VELEZ SARSFIELD;
Pediatria;Subtotal Pediatria;1765;436;2201;1769;3;1772;425;2197;14690;7007;4025;192;477;319;5459;14;2017;2120;HOSPITAL GENERAL DE AGUDOS D. VELEZ SARSFIELD;
Tocoginecologia;Obstetricia;1484;8;1492;1469;0;1469;28;1497;9040;5368;2477;1471;5938;359;6044;0;2017;2120;HOSPITAL GENERAL DE AGUDOS D. VELEZ SARSFIELD;
Tocoginecologia;Subtotal Tocoginecologia;1484;8;1492;1469;0;1469;28;1497;9040;5368;2477;1471;5938;359;6044;0;2017;2120;HOSPITAL GENERAL DE AGUDOS D. VELEZ SARSFIELD;
Urgencia;Terapia Intensiva;90;58;148;10;51;61;90;151;2154;1925;59;527;8937;1275;2559;3377;2017;2120;HOSPITAL GENERAL DE AGUDOS D. VELEZ SARSFIELD;
Urgencia;Subtotal Urgencia;90;58;148;10;51;61;90;151;2154;1925;59;527;8937;1275;2559;3377;2017;2120;HOSPITAL GENERAL DE AGUDOS D. VELEZ SARSFIELD;
Urgencia;Total Hospital;4872;657;5529;4704;169;4873;657;5530;41471;26359;11362;7222;6356;541;4289;347;2017;2120;HOSPITAL GENERAL DE AGUDOS D. VELEZ SARSFIELD;
Medicina;Unidad Coronaria;14;130;144;74;16;90;56;146;1975;1407;541;385;7124;964;2698;1096;2017;2118;HOSPITAL GENERAL DE AGUDOS A. ZUBIZARRETA;
Medicina;Subtotal Medicina;14;130;144;74;16;90;56;146;1975;1407;541;385;7124;964;2698;1096;2017;2118;HOSPITAL GENERAL DE AGUDOS A. ZUBIZARRETA;
Pediatria;Adolescencia;80;2;82;89;0;89;3;92;2552;856;699;235;3354;93;1316;0;2017;2118;HOSPITAL GENERAL DE AGUDOS A. ZUBIZARRETA;
Pediatria;Pediatría;359;1;360;382;0;382;0;382;4558;3465;1249;949;7602;907;3059;0;2017;2118;HOSPITAL GENERAL DE AGUDOS A. ZUBIZARRETA;
Pediatria;Subtotal Pediatria;439;3;442;471;0;471;3;474;7110;4321;1948;1184;6077;912;2433;0;2017;2118;HOSPITAL GENERAL DE AGUDOS A. ZUBIZARRETA;
Urgencia;Terapia Intermedia;1152;397;1549;1424;32;1456;90;1546;11040;6807;3025;1865;6166;44;5111;207;2017;2118;HOSPITAL GENERAL DE AGUDOS A. ZUBIZARRETA;
Urgencia;Terapia Intensiva;24;143;167;13;43;56;111;167;2262;1855;62;508;8201;1111;2695;2575;2017;2118;HOSPITAL GENERAL DE AGUDOS A. ZUBIZARRETA;
Urgencia;Subtotal Urgencia;1176;540;1716;1437;75;1512;201;1713;13302;8662;3644;2373;6512;506;47;438;2017;2118;HOSPITAL GENERAL DE AGUDOS A. ZUBIZARRETA;
Area Indiferenciada;Area Indiferenciada - Cuidados Alejados;1620;391;2011;1062;143;1205;804;2009;18930;13274;5186;3637;7012;661;3874;712;2017;2118;HOSPITAL GENERAL DE AGUDOS A. ZUBIZARRETA;
Area Indiferenciada;Subtotal Area Indiferenciada;1620;391;2011;1062;143;1205;804;2009;18930;13274;5186;3637;7012;661;3874;712;2017;2118;HOSPITAL GENERAL DE AGUDOS A. ZUBIZARRETA;
Area Indiferenciada;Total Hospital;3249;1064;4313;3044;234;3278;1064;4342;41317;27664;1132;7579;6696;844;2896;714;2017;2118;HOSPITAL GENERAL DE AGUDOS A. ZUBIZARRETA;
Medicina;Psicopatologia Y Salud Mental;25;4;29;27;0;27;4;31;2678;2448;734;671;9141;7897;423;0;2017;2172;HOSPITAL GENERAL DE NIÑOS PEDRO DE ELIZALDE;
Medicina;Subtotal Medicina;25;4;29;27;0;27;4;31;2678;2448;734;671;9141;7897;423;0;2017;2172;HOSPITAL GENERAL DE NIÑOS PEDRO DE ELIZALDE;
Cuidados Genereales - Area Indiferenciada;Sector 1;611;377;988;936;1;937;58;995;8062;6437;2209;1764;7984;647;4505;1;2017;2172;HOSPITAL GENERAL DE NIÑOS PEDRO DE ELIZALDE;
Cuidados Genereales - Area Indiferenciada;Sector 2;580;247;827;775;2;777;45;822;7330;5899;2008;1616;8048;718;4093;24;2017;2172;HOSPITAL GENERAL DE NIÑOS PEDRO DE ELIZALDE;
Cuidados Genereales - Area Indiferenciada;Sector 3 A;230;134;364;327;0;327;31;358;3640;2692;997;738;7396;752;359;0;2017;2172;HOSPITAL GENERAL DE NIÑOS PEDRO DE ELIZALDE;
Cuidados Genereales - Area Indiferenciada;Sector 3 B - Presión Negativa;185;80;265;207;0;207;52;259;4269;3149;117;863;7376;1216;2214;0;2017;2172;HOSPITAL GENERAL DE NIÑOS PEDRO DE ELIZALDE;
Cuidados Genereales - Area Indiferenciada;Sector 4;679;301;980;932;1;933;53;986;7941;5982;2176;1639;7533;607;4532;1;2017;2172;HOSPITAL GENERAL DE NIÑOS PEDRO DE ELIZALDE;
Cuidados Genereales - Area Indiferenciada;Sector 5;606;259;865;830;1;831;44;875;7844;5987;2149;164;7633;684;4072;11;2017;2172;HOSPITAL GENERAL DE NIÑOS PEDRO DE ELIZALDE;
Cuidados Genereales - Area Indiferenciada;Sector 6 A;399;99;498;432;1;433;64;497;4177;2621;1144;718;6275;527;4343;2;2017;2172;HOSPITAL GENERAL DE NIÑOS PEDRO DE ELIZALDE;
Cuidados Genereales - Area Indiferenciada;Sector 6 B - Presión Positiva;195;73;268;207;1;208;60;268;2864;1768;785;484;6173;66;3416;37;2017;2172;HOSPITAL GENERAL DE NIÑOS PEDRO DE ELIZALDE;
Cuidados Genereales - Area Indiferenciada;Sector 7;1863;194;2057;1912;0;1912;143;2055;9243;7029;2532;1926;7605;342;8115;0;2017;2172;HOSPITAL GENERAL DE NIÑOS PEDRO DE ELIZALDE;
Cuidados Genereales - Area Indiferenciada;Subtotal Cuidados Genereales - Area Indiferenciada;5348;1764;7112;6558;7;6565;550;7115;55370;41564;1517;11387;7507;584;469;1;2017;2172;HOSPITAL GENERAL DE NIÑOS PEDRO DE ELIZALDE;
Cuidados Especiales;Neonatología Alta Complejidad;93;13;106;24;17;41;64;105;4363;2421;1195;663;5549;2306;878;1619;2017;2172;HOSPITAL GENERAL DE NIÑOS PEDRO DE ELIZALDE;
Cuidados Especiales;Neonatología Mediana Complejidad;178;59;237;223;2;225;14;239;4429;3191;1213;874;7205;1335;197;84;2017;2172;HOSPITAL GENERAL DE NIÑOS PEDRO DE ELIZALDE;
Cuidados Especiales;Cuidados Intermedios;110;189;299;108;3;111;192;303;2909;1730;797;474;5947;571;3802;99;2017;2172;HOSPITAL GENERAL DE NIÑOS PEDRO DE ELIZALDE;
Cuidados Especiales;Cuidados Intensivos;131;206;337;9;35;44;295;339;4015;2202;11;603;5484;65;3082;1032;2017;2172;HOSPITAL GENERAL DE NIÑOS PEDRO DE ELIZALDE;
Cuidados Especiales;Cirugía Cardiovascular;94;20;114;88;9;97;18;115;2905;1267;796;347;4361;1102;1445;783;2017;2172;HOSPITAL GENERAL DE NIÑOS PEDRO DE ELIZALDE;
Cuidados Especiales;Guardia;2434;1;2435;1313;2;1315;1119;2434;2995;2733;821;749;9125;112;29663;8;2017;2172;HOSPITAL GENERAL DE NIÑOS PEDRO DE ELIZALDE;
Cuidados Especiales;Subtotal Cuidados Especiales;3040;488;3528;1765;68;1833;1702;3535;21616;13544;5922;3711;6266;383;5969;192;2017;2172;HOSPITAL GENERAL DE NIÑOS PEDRO DE ELIZALDE;
Cuidados Especiales;Total Hospital;8413;2256;10669;8350;75;8425;2256;10681;79664;57556;21826;15769;7225;683;386;89;2017;2172;HOSPITAL GENERAL DE NIÑOS PEDRO DE ELIZALDE;
Medicina;Pediatria;2859;590;3449;2972;7;2979;463;3442;35371;29382;9691;805;8307;854;3552;2;2017;2164;HOSPITAL GENERAL DE NIÑOS RICARDO GUTIERREZ;
Medicina;Endocrinología;196;0;196;196;0;196;0;196;2143;196;587;54;915;1;3338;0;2017;2164;HOSPITAL GENERAL DE NIÑOS RICARDO GUTIERREZ;
Medicina;Infecciosas;584;158;742;579;10;589;140;729;9188;8421;2517;2307;9165;1155;2896;137;2017;2164;HOSPITAL GENERAL DE NIÑOS RICARDO GUTIERREZ;
Medicina;Neonatología;250;17;267;234;9;243;22;265;6641;5409;1819;1482;8145;2041;1456;34;2017;2164;HOSPITAL GENERAL DE NIÑOS RICARDO GUTIERREZ;
Medicina;Centro Respiratorio;235;100;335;239;0;239;96;335;4417;3744;121;1026;8476;1118;2768;0;2017;2164;HOSPITAL GENERAL DE NIÑOS RICARDO GUTIERREZ;
Medicina;Nefrología;367;34;401;372;1;373;24;397;4168;2232;1142;612;5355;562;3477;25;2017;2164;HOSPITAL GENERAL DE NIÑOS RICARDO GUTIERREZ;
Medicina;Subtotal Medicina;4491;899;5390;4592;27;4619;745;5364;61928;49384;16967;1353;7974;921;3162;5;2017;2164;HOSPITAL GENERAL DE NIÑOS RICARDO GUTIERREZ;
Cirugia;Cirugía General;1475;155;1630;1444;0;1444;190;1634;8970;5019;2458;1375;5595;307;6649;0;2017;2164;HOSPITAL GENERAL DE NIÑOS RICARDO GUTIERREZ;
Cirugia;Cirugía Cardiovascular;327;30;357;320;16;336;22;358;7533;4871;2064;1335;6466;1361;1735;447;2017;2164;HOSPITAL GENERAL DE NIÑOS RICARDO GUTIERREZ;
Cirugia;Cirugía Plástica Y Reparadora - niÃ±os;642;20;662;623;0;623;39;662;3299;1715;904;47;5199;259;7324;0;2017;2164;HOSPITAL GENERAL DE NIÑOS RICARDO GUTIERREZ;
Cirugia;Neurocirugía;450;103;553;439;2;441;111;552;8136;3235;2229;886;3976;586;2476;36;2017;2164;HOSPITAL GENERAL DE NIÑOS RICARDO GUTIERREZ;
Cirugia;Ortopedia Y Traumatología;1368;126;1494;1346;0;1346;138;1484;11428;6164;3131;1689;5394;415;474;0;2017;2164;HOSPITAL GENERAL DE NIÑOS RICARDO GUTIERREZ;
Cirugia;Urologia;306;8;314;308;0;308;5;313;4196;1329;115;364;3167;425;2723;0;2017;2164;HOSPITAL GENERAL DE NIÑOS RICARDO GUTIERREZ;
Cirugia;Cirugía General;694;104;798;703;1;704;97;801;2904;2918;796;799;10048;364;10068;12;2017;2123;HOSPITAL GENERAL DE AGUDOS DR. C. DURAND;
Cirugia;Cirugía Cardiovascular;27;116;143;30;6;36;106;142;1453;370;398;101;2546;261;3567;423;2017;2123;HOSPITAL GENERAL DE AGUDOS DR. C. DURAND;
Cirugia;Cirugía Plástica Y Reparadora - niÃ±os;30;2;32;31;0;31;1;32;63;63;17;17;100;197;1854;0;2017;2123;HOSPITAL GENERAL DE AGUDOS DR. C. DURAND;
Cirugia;Oftalmología;4;2;6;4;0;4;2;6;12;9;3;2;75;15;1825;0;2017;2123;HOSPITAL GENERAL DE AGUDOS DR. C. DURAND;
Cirugia;Ortopedia Y Traumatología;432;26;458;437;4;441;20;461;4570;4578;1252;1254;10018;993;3682;87;2017;2123;HOSPITAL GENERAL DE AGUDOS DR. C. DURAND;
Cirugia;Otorrinolaringología;92;5;97;92;0;92;4;96;327;327;9;9;100;341;10716;0;2017;2123;HOSPITAL GENERAL DE AGUDOS DR. C. DURAND;
Cirugia;Urología;305;17;322;304;1;305;19;324;1083;1088;297;298;10046;336;1092;31;2017;2123;HOSPITAL GENERAL DE AGUDOS DR. C. DURAND;
Cirugia;Vascular Periférico;20;12;32;25;1;26;7;33;201;201;55;55;100;609;5993;303;2017;2123;HOSPITAL GENERAL DE AGUDOS DR. C. DURAND;
Cirugia;Subtotal Cirugia;1604;284;1888;1626;13;1639;256;1895;10613;9554;2908;2618;9002;504;6517;69;2017;2123;HOSPITAL GENERAL DE AGUDOS DR. C. DURAND;
Pediatria;Recien Nacido Sano;1066;107;1173;1160;0;1160;18;1178;9120;3928;2499;1076;4307;333;4715;0;2017;2123;HOSPITAL GENERAL DE AGUDOS DR. C. DURAND;
Pediatria;Neonatología;322;157;479;219;8;227;249;476;7308;3819;2002;1046;5226;802;2377;168;2017;2123;HOSPITAL GENERAL DE AGUDOS DR. C. DURAND;
Pediatria;Pediatría;779;79;858;820;0;820;38;858;8228;4813;2254;1319;585;561;3806;0;2017;2123;HOSPITAL GENERAL DE AGUDOS DR. C. DURAND;
Pediatria;Subtotal Pediatria;2167;343;2510;2199;8;2207;305;2512;24656;12560;6755;3441;5094;5;3719;32;2017;2123;HOSPITAL GENERAL DE AGUDOS DR. C. DURAND;
Tocoginecologia;Tocoginecología;2163;65;2228;2165;2;2167;70;2237;15416;9652;4224;2644;6261;431;5296;9;2017;2123;HOSPITAL GENERAL DE AGUDOS DR. C. DURAND;
Tocoginecologia;Subtotal Tocoginecologia;2163;65;2228;2165;2;2167;70;2237;15416;9652;4224;2644;6261;431;5296;9;2017;2123;HOSPITAL GENERAL DE AGUDOS DR. C. DURAND;
Urgencia;Terapia Intermedia;58;39;97;19;2;21;72;93;2920;1355;8;371;464;1457;1163;215;2017;2123;HOSPITAL GENERAL DE AGUDOS DR. C. DURAND;
Urgencia;Cuidados Intermedios;33;151;184;23;12;35;146;181;2537;2414;695;661;9515;1334;2604;663;2017;2123;HOSPITAL GENERAL DE AGUDOS DR. C. DURAND;
Urgencia;Guardia Del Día;1170;44;1214;345;236;581;639;1220;7294;7340;1998;2011;10063;602;6105;1934;2017;2123;HOSPITAL GENERAL DE AGUDOS DR. C. DURAND;
Urgencia;Terapia Intensiva;51;185;236;10;51;61;173;234;3053;2691;836;737;8814;115;2798;2179;2017;2123;HOSPITAL GENERAL DE AGUDOS DR. C. DURAND;
Urgencia;Subtotal Urgencia;1312;419;1731;397;301;698;1030;1728;15804;13800;433;3781;8732;799;3991;1742;2017;2123;HOSPITAL GENERAL DE AGUDOS DR. C. DURAND;
Urgencia;Total Hospital;8029;2113;10142;7552;491;8043;2113;10156;100981;73994;27666;20272;7328;92;2907;61;2017;2123;HOSPITAL GENERAL DE AGUDOS DR. C. DURAND;
Medicina;Cardiología;112;183;295;185;9;194;99;293;2190;1918;6;525;8758;655;4883;307;2017;2127;HOSPITAL GENERAL DE AGUDOS DR. J. A. FERNANDEZ;
Medicina;Clínica Médica;1055;503;1558;1154;156;1310;249;1559;27982;26787;7666;7339;9573;1718;2034;1001;2017;2127;HOSPITAL GENERAL DE AGUDOS DR. J. A. FERNANDEZ;
Medicina;Unidad Coronaria;390;95;485;231;42;273;210;483;3072;1951;842;535;6351;404;5739;87;2017;2127;HOSPITAL GENERAL DE AGUDOS DR. J. A. FERNANDEZ;
Medicina;Subtotal Medicina;1557;781;2338;1570;207;1777;558;2335;33244;30656;9108;8399;9222;1313;2564;887;2017;2127;HOSPITAL GENERAL DE AGUDOS DR. J. A. FERNANDEZ;
Cirugia;Cirugía General;725;320;1045;793;3;796;256;1052;14384;13192;3941;3614;9171;1254;2669;29;2017;2127;HOSPITAL GENERAL DE AGUDOS DR. J. A. FERNANDEZ;
Cirugia;Ginecología;536;337;873;712;8;720;156;876;6898;5065;189;1388;7343;578;4635;91;2017;2127;HOSPITAL GENERAL DE AGUDOS DR. J. A. FERNANDEZ;
Cirugia;Neurocirugía;157;100;257;161;0;161;99;260;3901;3346;1069;917;8577;1287;2433;0;2017;2127;HOSPITAL GENERAL DE AGUDOS DR. J. A. FERNANDEZ;
Cirugia;Ortopedia Y Traumatología;1115;101;1216;1051;6;1057;171;1228;15441;11043;423;3025;7152;899;2903;49;2017;2127;HOSPITAL GENERAL DE AGUDOS DR. J. A. FERNANDEZ;
Cirugia;Urología;224;49;273;210;1;211;61;272;3446;3138;944;86;9106;1154;2881;37;2017;2127;HOSPITAL GENERAL DE AGUDOS DR. J. A. FERNANDEZ;
Cirugia;Subtotal Cirugia;2757;907;3664;2927;18;2945;743;3688;44070;35784;12074;9804;812;97;3055;49;2017;2127;HOSPITAL GENERAL DE AGUDOS DR. J. A. FERNANDEZ;
Pediatria;Recien Nacido Sano;1264;32;1296;1232;0;1232;70;1302;10217;3999;2799;1096;3914;307;4651;0;2017;2127;HOSPITAL GENERAL DE AGUDOS DR. J. A. FERNANDEZ;
Pediatria;Neonatología;336;69;405;356;24;380;33;413;8033;5138;2201;1408;6396;1244;1877;581;2017;2127;HOSPITAL GENERAL DE AGUDOS DR. J. A. FERNANDEZ;
Pediatria;Pediatría;638;6;644;641;0;641;3;644;6328;2972;1734;814;4697;461;3715;0;2017;2127;HOSPITAL GENERAL DE AGUDOS DR. J. A. FERNANDEZ;
Pediatria;Subtotal Pediatria;2238;107;2345;2229;24;2253;106;2359;24578;12109;6734;3318;4927;513;3503;102;2017;2127;HOSPITAL GENERAL DE AGUDOS DR. J. A. FERNANDEZ;
Tocoginecologia;Obstetricia;2004;13;2017;1710;0;1710;311;2021;10763;6409;2949;1756;5955;317;6854;0;2017;2127;HOSPITAL GENERAL DE AGUDOS DR. J. A. FERNANDEZ;
Tocoginecologia;Subtotal Tocoginecologia;2004;13;2017;1710;0;1710;311;2021;10763;6409;2949;1756;5955;317;6854;0;2017;2127;HOSPITAL GENERAL DE AGUDOS DR. J. A. FERNANDEZ;
Urgencia;Terapia Intermedia;16;136;152;13;12;25;127;152;4133;3998;1132;1095;9673;263;1342;789;2017;2127;HOSPITAL GENERAL DE AGUDOS DR. J. A. FERNANDEZ;
Urgencia;Toxicología;162;12;174;159;0;159;17;176;2910;1722;797;472;5918;978;2208;0;2017;2127;HOSPITAL GENERAL DE AGUDOS DR. J. A. FERNANDEZ;
Urgencia;Terapia Intensiva;214;359;573;17;103;120;453;573;6276;5256;1719;144;8375;917;3332;1798;2017;2127;HOSPITAL GENERAL DE AGUDOS DR. J. A. FERNANDEZ;
Urgencia;Subtotal Urgencia;392;507;899;189;115;304;597;901;13319;10976;3649;3007;8241;1218;2469;1276;2017;2127;HOSPITAL GENERAL DE AGUDOS DR. J. A. FERNANDEZ;
Urgencia;Total Hospital;8948;2315;11263;8625;364;8989;2315;11304;125974;95934;34513;26283;7615;1067;2604;405;2017;2127;HOSPITAL GENERAL DE AGUDOS DR. J. A. FERNANDEZ;
Medicina;Clínica Médica;65;540;605;480;71;551;54;605;17671;16802;4841;4603;9508;2777;125;1174;2017;2161;HOSPITAL GENERAL DE AGUDOS J. A. PENNA;
Medicina;Subtotal Medicina;65;540;605;480;71;551;54;605;17671;16802;4841;4603;9508;2777;125;1174;2017;2161;HOSPITAL GENERAL DE AGUDOS J. A. PENNA;
Cirugia;Cirugía General;1042;136;1178;1112;12;1124;63;1187;13143;7923;3601;2171;6028;667;3296;101;2017;2161;HOSPITAL GENERAL DE AGUDOS J. A. PENNA;
Cirugia;Ortopedia Y Traumatología;120;125;245;232;7;239;14;253;6228;4520;1706;1238;7258;1787;1483;277;2017;2161;HOSPITAL GENERAL DE AGUDOS J. A. PENNA;
Cirugia;Urología;204;33;237;214;2;216;19;235;2485;2270;681;622;9135;966;3452;85;2017;2161;HOSPITAL GENERAL DE AGUDOS J. A. PENNA;
Cirugia;Subtotal Cirugia;1366;294;1660;1558;21;1579;96;1675;21856;14713;5988;4031;6732;878;2797;125;2017;2161;HOSPITAL GENERAL DE AGUDOS J. A. PENNA;
Pediatria;Recien Nacido Sano;2820;299;3119;2961;0;2961;154;3115;17526;10716;4802;2936;6114;344;6487;0;2017;2161;HOSPITAL GENERAL DE AGUDOS J. A. PENNA;
Pediatria;Neonatología;541;139;680;358;23;381;285;666;8432;5807;231;1591;6887;872;2883;345;2017;2161;HOSPITAL GENERAL DE AGUDOS J. A. PENNA;
Pediatria;Pediatría;956;20;976;964;0;964;6;970;8396;4507;23;1235;5368;465;4217;0;2017;2161;HOSPITAL GENERAL DE AGUDOS J. A. PENNA;
Pediatria;Subtotal Pediatria;4317;458;4775;4283;23;4306;445;4751;34354;21030;9412;5762;6122;443;5048;48;2017;2161;HOSPITAL GENERAL DE AGUDOS J. A. PENNA;
Tocoginecologia;Tocoginecología;5235;118;5353;5216;5;5221;129;5350;24860;19609;6811;5372;7888;367;7855;9;2017;2161;HOSPITAL GENERAL DE AGUDOS J. A. PENNA;
Tocoginecologia;Subtotal Tocoginecologia;5235;118;5353;5216;5;5221;129;5350;24860;19609;6811;5372;7888;367;7855;9;2017;2161;HOSPITAL GENERAL DE AGUDOS J. A. PENNA;
Urgencia;Terapia Intermedia;13;126;139;7;22;29;109;138;1450;1449;397;397;9993;105;3474;1594;2017;2161;HOSPITAL GENERAL DE AGUDOS J. A. PENNA;
Urgencia;Guardia Del Día;3095;5;3100;2105;240;2345;747;3092;11245;11242;3081;308;9997;364;10036;776;2017;2161;HOSPITAL GENERAL DE AGUDOS J. A. PENNA;
Urgencia;Terapia Intensiva;12;136;148;7;42;49;97;146;2315;2305;634;632;9957;1579;2302;2877;2017;2161;HOSPITAL GENERAL DE AGUDOS J. A. PENNA;
Urgencia;Subtotal Urgencia;3120;267;3387;2119;304;2423;953;3376;15010;14996;4112;4108;9991;444;8209;9;2017;2161;HOSPITAL GENERAL DE AGUDOS J. A. PENNA;
Urgencia;Total Hospital;14103;1677;15780;13656;424;14080;1677;15757;113751;87150;31165;23877;7661;619;4518;301;2017;2161;HOSPITAL GENERAL DE AGUDOS J. A. PENNA;
Medicina;Cardiología;19;9;28;24;0;24;4;28;2194;44;601;12;201;157;466;0;2017;2125;HOSPITAL GENERAL DE AGUDOS DR. I. PIROVANO;
Medicina;Clínica Médica;1014;428;1442;968;240;1208;243;1451;26942;25113;7381;688;9321;1731;1966;1654;2017;2125;HOSPITAL GENERAL DE AGUDOS DR. I. PIROVANO;
Medicina;Unidad Coronaria;185;22;207;171;21;192;15;207;2676;1999;733;548;747;966;2823;1014;2017;2125;HOSPITAL GENERAL DE AGUDOS DR. I. PIROVANO;
Medicina;Subtotal Medicina;1218;459;1677;1163;261;1424;262;1686;31812;27156;8716;744;8536;1611;1934;1548;2017;2125;HOSPITAL GENERAL DE AGUDOS DR. I. PIROVANO;
Cirugia;Cirugía General;1167;142;1309;1135;40;1175;142;1317;19329;14351;5296;3932;7425;109;2487;304;2017;2125;HOSPITAL GENERAL DE AGUDOS DR. I. PIROVANO;
Cirugia;Ginecología;709;137;846;616;8;624;227;851;6185;5058;1695;1386;8178;594;5022;94;2017;2125;HOSPITAL GENERAL DE AGUDOS DR. I. PIROVANO;
Cirugia;Neurocirugía;202;53;255;214;1;215;43;258;4517;3743;1238;1025;8286;1451;2085;39;2017;2125;HOSPITAL GENERAL DE AGUDOS DR. I. PIROVANO;
Cirugia;Oftalmología;244;17;261;236;0;236;24;260;2553;912;699;25;3572;351;3717;0;2017;2125;HOSPITAL GENERAL DE AGUDOS DR. I. PIROVANO;
Cirugia;Ortopedia Y Traumatología;482;87;569;431;11;442;135;577;16375;12995;4486;356;7936;2252;1286;191;2017;2125;HOSPITAL GENERAL DE AGUDOS DR. I. PIROVANO;
Cirugia;Otorrinolaringología;140;14;154;141;0;141;15;156;2920;605;8;166;2072;388;195;0;2017;2125;HOSPITAL GENERAL DE AGUDOS DR. I. PIROVANO;
Cirugia;Urología;343;76;419;377;9;386;33;419;4277;3440;1172;942;8043;821;3576;215;2017;2125;HOSPITAL GENERAL DE AGUDOS DR. I. PIROVANO;
Cirugia;Subtotal Cirugia;3287;526;3813;3150;69;3219;619;3838;56156;41104;15385;11261;732;1071;2495;18;2017;2125;HOSPITAL GENERAL DE AGUDOS DR. I. PIROVANO;
Pediatria;Recien Nacido Sano;754;0;754;656;0;656;97;753;11315;2319;31;635;2049;308;2429;0;2017;2125;HOSPITAL GENERAL DE AGUDOS DR. I. PIROVANO;
Pediatria;Neonatología;214;97;311;310;1;311;0;311;3325;2377;911;651;7149;764;3414;32;2017;2125;HOSPITAL GENERAL DE AGUDOS DR. I. PIROVANO;
Pediatria;Pediatría;853;0;853;853;0;853;1;854;9490;2646;26;725;2788;31;3285;0;2017;2125;HOSPITAL GENERAL DE AGUDOS DR. I. PIROVANO;
Pediatria;Subtotal Pediatria;1821;97;1918;1819;1;1820;98;1918;24130;7342;6611;2012;3043;383;2901;5;2017;2125;HOSPITAL GENERAL DE AGUDOS DR. I. PIROVANO;
Tocoginecologia;Obstetricia;1600;10;1610;1508;1;1509;102;1611;11195;5702;3067;1562;5093;354;5252;6;2017;2125;HOSPITAL GENERAL DE AGUDOS DR. I. PIROVANO;
Tocoginecologia;Subtotal Tocoginecologia;1600;10;1610;1508;1;1509;102;1611;11195;5702;3067;1562;5093;354;5252;6;2017;2125;HOSPITAL GENERAL DE AGUDOS DR. I. PIROVANO;
Urgencia;Terapia Intermedia;0;0;0;0;0;0;0;0;1460;0;4;0;0;0;;;2017;2125;HOSPITAL GENERAL DE AGUDOS DR. I. PIROVANO;
Urgencia;Terapia Intensiva;95;228;323;18;68;86;239;325;3709;3707;1016;1016;9995;1141;3198;2092;2017;2125;HOSPITAL GENERAL DE AGUDOS DR. I. PIROVANO;
Urgencia;Subtotal Urgencia;95;228;323;18;68;86;239;325;5169;3707;1416;1016;7172;1141;2295;2092;2017;2125;HOSPITAL GENERAL DE AGUDOS DR. I. PIROVANO;
Urgencia;Total Hospital;8021;1320;9341;7658;400;8058;1320;9378;128462;85011;35195;23291;6618;1055;229;496;2017;2125;HOSPITAL GENERAL DE AGUDOS DR. I. PIROVANO;
Medicina;Cardiología;159;331;490;388;6;394;94;488;6948;3933;1904;1078;5661;806;2564;123;2017;2162;HOSPITAL GENERAL DE AGUDOS J. M. RAMOS MEJIA;
Medicina;Clínica Médica;394;1045;1439;1118;131;1249;189;1438;36172;30284;991;8297;8372;2106;1451;911;2017;2162;HOSPITAL GENERAL DE AGUDOS J. M. RAMOS MEJIA;
Medicina;Dermatología;91;26;117;96;2;98;17;115;3643;3054;998;837;8383;2656;1152;174;2017;2162;HOSPITAL GENERAL DE AGUDOS J. M. RAMOS MEJIA;
Medicina;Stroke ;81;20;101;63;2;65;36;101;842;463;231;127;5499;458;4378;198;2017;2162;HOSPITAL GENERAL DE AGUDOS J. M. RAMOS MEJIA;
Medicina;Hematología;273;35;308;267;16;283;22;305;4764;4521;1305;1239;949;1482;2337;525;2017;2162;HOSPITAL GENERAL DE AGUDOS J. M. RAMOS MEJIA;
Medicina;Neurología;401;113;514;482;1;483;28;511;5169;4223;1416;1157;817;826;3608;2;2017;2162;HOSPITAL GENERAL DE AGUDOS J. M. RAMOS MEJIA;
Medicina;Tisiología;67;69;136;110;4;114;21;135;4886;2867;1339;785;5868;2124;1008;296;2017;2162;HOSPITAL GENERAL DE AGUDOS J. M. RAMOS MEJIA;
Medicina;Unidad Coronaria;336;153;489;103;51;154;333;487;2535;2036;695;558;8032;418;7012;1047;2017;2162;HOSPITAL GENERAL DE AGUDOS J. M. RAMOS MEJIA;
Medicina;Subtotal Medicina;1802;1792;3594;2627;213;2840;740;3580;64959;51381;17797;14077;791;1435;2012;595;2017;2162;HOSPITAL GENERAL DE AGUDOS J. M. RAMOS MEJIA;
Cirugia;Cirugía General;965;252;1217;1067;15;1082;132;1214;22263;13603;6099;3727;611;1121;199;124;2017;2162;HOSPITAL GENERAL DE AGUDOS J. M. RAMOS MEJIA;
Cirugia;Cirugía Plástica Y Reparadora - niÃ±os;412;1;413;409;0;409;1;410;4615;990;1264;271;2145;241;3243;0;2017;2162;HOSPITAL GENERAL DE AGUDOS J. M. RAMOS MEJIA;
Cirugia;Ginecología;306;14;320;307;5;312;8;320;5062;1874;1387;513;3702;586;2307;156;2017;2162;HOSPITAL GENERAL DE AGUDOS J. M. RAMOS MEJIA;
Cirugia;Neurocirugía;114;81;195;142;0;142;53;195;970;673;266;184;6938;345;7338;0;2017;2162;HOSPITAL GENERAL DE AGUDOS J. M. RAMOS MEJIA;
Cirugia;Oftalmología;0;0;0;0;0;0;0;0;60;0;16;0;0;0;;;2017;2162;HOSPITAL GENERAL DE AGUDOS J. M. RAMOS MEJIA;
Cirugia;Ortopedia Y Traumatología;290;46;336;308;9;317;15;332;9919;6514;2718;1785;6567;1962;1222;271;2017;2162;HOSPITAL GENERAL DE AGUDOS J. M. RAMOS MEJIA;
Cirugia;Otorrinolaringología;87;0;87;91;0;91;0;91;193;82;53;22;4249;9;1721;0;2017;2162;HOSPITAL GENERAL DE AGUDOS J. M. RAMOS MEJIA;
Cirugia;Urología;200;110;310;274;3;277;25;302;6245;3725;1711;1021;5965;1233;1765;99;2017;2162;HOSPITAL GENERAL DE AGUDOS J. M. RAMOS MEJIA;
Cirugia;Subtotal Cirugia;2374;504;2878;2598;32;2630;234;2864;49327;27461;13514;7524;5567;959;2119;112;2017;2162;HOSPITAL GENERAL DE AGUDOS J. M. RAMOS MEJIA;
Pediatria;Recien Nacido Sano;1063;0;1063;998;1;999;63;1062;5852;2990;1603;819;5109;282;6624;9;2017;2162;HOSPITAL GENERAL DE AGUDOS J. M. RAMOS MEJIA;
Pediatria;Neonatología;217;63;280;276;1;277;0;277;4356;2518;1193;69;5781;909;2321;36;2017;2162;HOSPITAL GENERAL DE AGUDOS J. M. RAMOS MEJIA;
Pediatria;Pediatría;504;2;506;508;2;510;0;510;7890;2292;2162;628;2905;449;2359;39;2017;2162;HOSPITAL GENERAL DE AGUDOS J. M. RAMOS MEJIA;
Pediatria;Subtotal Pediatria;1784;65;1849;1782;4;1786;63;1849;18098;7800;4958;2137;431;422;3729;22;2017;2162;HOSPITAL GENERAL DE AGUDOS J. M. RAMOS MEJIA;
Tocoginecologia;Obstetricia;1595;9;1604;1585;0;1585;11;1596;8731;5479;2392;1501;6275;343;6672;0;2017;2162;HOSPITAL GENERAL DE AGUDOS J. M. RAMOS MEJIA;
Tocoginecologia;Subtotal Tocoginecologia;1595;9;1604;1585;0;1585;11;1596;8731;5479;2392;1501;6275;343;6672;0;2017;2162;HOSPITAL GENERAL DE AGUDOS J. M. RAMOS MEJIA;
Urgencia;Guardia Del Día;2550;93;2643;785;380;1165;1480;2645;4530;5454;1241;1494;1204;206;21312;1437;2017;2162;HOSPITAL GENERAL DE AGUDOS J. M. RAMOS MEJIA;
Urgencia;Terapia Intensiva;15;287;302;7;71;78;222;300;4481;3925;1228;1075;8759;1308;2444;2367;2017;2162;HOSPITAL GENERAL DE AGUDOS J. M. RAMOS MEJIA;
Urgencia;Subtotal Urgencia;2565;380;2945;792;451;1243;1702;2945;9011;9379;2469;257;10408;318;11929;1531;2017;2162;HOSPITAL GENERAL DE AGUDOS J. M. RAMOS MEJIA;
Urgencia;Total Hospital;10120;2750;12870;9384;700;10084;2750;12834;150126;101500;4113;27808;6761;1007;2452;694;2017;2162;HOSPITAL GENERAL DE AGUDOS J. M. RAMOS MEJIA;
Medicina;Cardiología;130;183;313;288;2;290;22;312;4349;1189;1192;326;2734;381;2619;64;2017;2119;HOSPITAL GENERAL DE AGUDOS B. RIVADAVIA;
Medicina;Clínica Médica;651;85;736;544;108;652;79;731;17489;13913;4792;3812;7955;1903;1526;1477;2017;2119;HOSPITAL GENERAL DE AGUDOS B. RIVADAVIA;
Medicina;Nutrición;80;12;92;89;0;89;3;92;3152;971;864;266;3081;1055;1065;0;2017;2119;HOSPITAL GENERAL DE AGUDOS B. RIVADAVIA;
Medicina;Curieterapia;21;0;21;18;0;18;3;21;1802;65;494;18;361;31;425;0;2017;2119;HOSPITAL GENERAL DE AGUDOS B. RIVADAVIA;
Medicina;Unidad Coronaria;243;43;286;76;4;80;207;287;2026;1470;555;403;7256;512;5171;139;2017;2119;HOSPITAL GENERAL DE AGUDOS B. RIVADAVIA;
Medicina;Subtotal Medicina;1125;323;1448;1015;114;1129;314;1443;28818;17608;7895;4824;611;122;1828;79;2017;2119;HOSPITAL GENERAL DE AGUDOS B. RIVADAVIA;
Cirugia;Cirugía General;804;43;847;806;9;815;38;853;13467;4830;369;1323;3587;566;2312;106;2017;2119;HOSPITAL GENERAL DE AGUDOS B. RIVADAVIA;
Cirugia;Cirugía Cardiovascular;60;17;77;61;0;61;15;76;1819;520;498;142;2859;684;1525;0;2017;2119;HOSPITAL GENERAL DE AGUDOS B. RIVADAVIA;
Cirugia;Ginecología;400;5;405;395;1;396;8;404;5840;1231;16;337;2108;305;2525;25;2017;2119;HOSPITAL GENERAL DE AGUDOS B. RIVADAVIA;
Cirugia;Neurocirugía;82;17;99;83;1;84;15;99;1853;652;508;179;3519;659;195;101;2017;2119;HOSPITAL GENERAL DE AGUDOS B. RIVADAVIA;
Cirugia;Ortopedia Y Traumatología;288;14;302;283;4;287;12;299;5157;3424;1413;938;664;1145;2116;134;2017;2119;HOSPITAL GENERAL DE AGUDOS B. RIVADAVIA;
Cirugia;Otorrinolaringología;141;1;142;141;0;141;1;142;2608;248;715;68;951;175;1987;0;2017;2119;HOSPITAL GENERAL DE AGUDOS B. RIVADAVIA;
Cirugia;Urología;252;12;264;246;4;250;14;264;4380;1430;12;392;3265;542;22;152;2017;2119;HOSPITAL GENERAL DE AGUDOS B. RIVADAVIA;
Cirugia;Subtotal Cirugia;2027;109;2136;2015;19;2034;103;2137;35124;12335;9623;3379;3512;577;2221;89;2017;2119;HOSPITAL GENERAL DE AGUDOS B. RIVADAVIA;
Pediatria;Recien Nacido Sano;778;154;932;869;0;869;62;931;3282;3280;899;899;9994;352;10354;0;2017;2119;HOSPITAL GENERAL DE AGUDOS B. RIVADAVIA;
Pediatria;Neonatología;261;66;327;173;2;175;158;333;7738;4177;212;1144;5398;1254;1571;6;2017;2119;HOSPITAL GENERAL DE AGUDOS B. RIVADAVIA;
Pediatria;Pediatría;612;4;616;611;0;611;4;615;6907;2403;1892;658;3479;391;325;0;2017;2119;HOSPITAL GENERAL DE AGUDOS B. RIVADAVIA;
Pediatria;Subtotal Pediatria;1651;224;1875;1653;2;1655;224;1879;17927;9860;4912;2701;55;525;3826;11;2017;2119;HOSPITAL GENERAL DE AGUDOS B. RIVADAVIA;
Tocoginecologia;Obstetricia;1327;9;1336;1330;0;1330;8;1338;15399;7299;4219;20;474;546;3171;0;2017;2119;HOSPITAL GENERAL DE AGUDOS B. RIVADAVIA;
Tocoginecologia;Subtotal Tocoginecologia;1327;9;1336;1330;0;1330;8;1338;15399;7299;4219;20;474;546;3171;0;2017;2119;HOSPITAL GENERAL DE AGUDOS B. RIVADAVIA;
Urgencia;Coordinacion Cuidados Intensivos;74;113;187;12;48;60;129;189;2753;2286;754;626;8304;121;2506;254;2017;2119;HOSPITAL GENERAL DE AGUDOS B. RIVADAVIA;
Urgencia;Subtotal Urgencia;74;113;187;12;48;60;129;189;2753;2286;754;626;8304;121;2506;254;2017;2119;HOSPITAL GENERAL DE AGUDOS B. RIVADAVIA;
Urgencia;Total Hospital;6204;778;6982;6025;183;6208;778;6986;100021;49388;27403;13531;4938;796;2265;295;2017;2119;HOSPITAL GENERAL DE AGUDOS B. RIVADAVIA;
Medicina;Cardiología;256;223;479;376;8;384;96;480;4380;2207;12;605;5039;46;40;167;2017;2121;HOSPITAL GENERAL DE AGUDOS DONACION F. SANTOJANNI;
Medicina;Clínica Médica;991;255;1246;885;184;1069;171;1240;24677;23747;6761;6506;9623;1915;1834;1484;2017;2121;HOSPITAL GENERAL DE AGUDOS DONACION F. SANTOJANNI;
Medicina;Unidad Coronaria;666;171;837;433;54;487;346;833;2920;2306;8;632;7897;277;10413;648;2017;2121;HOSPITAL GENERAL DE AGUDOS DONACION F. SANTOJANNI;
Medicina;Subtotal Medicina;1913;649;2562;1694;246;1940;613;2553;31977;28260;8761;7742;8838;1107;2914;964;2017;2121;HOSPITAL GENERAL DE AGUDOS DONACION F. SANTOJANNI;
Cirugia;Cirugía General;1004;128;1132;1054;13;1067;56;1123;11265;7815;3086;2141;6937;696;3639;116;2017;2121;HOSPITAL GENERAL DE AGUDOS DONACION F. SANTOJANNI;
Cirugia;Cirugía Cardiovascular;53;0;53;53;0;53;0;53;728;53;199;15;728;1;2657;0;2017;2121;HOSPITAL GENERAL DE AGUDOS DONACION F. SANTOJANNI;
Cirugia;Microcirugia Y Cirugia Reparadora;466;6;472;467;0;467;5;472;1841;742;504;203;403;157;9358;0;2017;2121;HOSPITAL GENERAL DE AGUDOS DONACION F. SANTOJANNI;
Cirugia;Ginecología;474;32;506;481;3;484;18;502;3898;3126;1068;856;8019;623;4701;6;2017;2121;HOSPITAL GENERAL DE AGUDOS DONACION F. SANTOJANNI;
Cirugia;Neurocirugía;184;49;233;200;2;202;38;240;4211;3537;1154;969;8399;1474;208;83;2017;2121;HOSPITAL GENERAL DE AGUDOS DONACION F. SANTOJANNI;
Cirugia;Ortopedia Y Traumatología;643;44;687;635;21;656;42;698;9749;9370;2671;2567;9611;1342;2613;301;2017;2121;HOSPITAL GENERAL DE AGUDOS DONACION F. SANTOJANNI;
Cirugia;Otorrinolaringología;53;0;53;53;0;53;0;53;108;99;3;27;9167;187;17912;0;2017;2121;HOSPITAL GENERAL DE AGUDOS DONACION F. SANTOJANNI;
Cirugia;Urología;334;20;354;339;0;339;10;349;1923;1200;527;329;624;344;6624;0;2017;2121;HOSPITAL GENERAL DE AGUDOS DONACION F. SANTOJANNI;
Cirugia;Subtotal Cirugia;3211;279;3490;3282;39;3321;169;3490;33723;25942;9239;7107;7693;743;3777;112;2017;2121;HOSPITAL GENERAL DE AGUDOS DONACION F. SANTOJANNI;
Pediatria;Recien Nacido Sano;2161;173;2334;2268;0;2268;46;2314;21900;9654;60;2645;4408;417;3857;0;2017;2121;HOSPITAL GENERAL DE AGUDOS DONACION F. SANTOJANNI;
Pediatria;Neonatología;338;159;497;196;22;218;284;502;10950;5234;30;1434;478;1043;1673;438;2017;2121;HOSPITAL GENERAL DE AGUDOS DONACION F. SANTOJANNI;
Pediatria;Pediatría;847;0;847;848;0;848;0;848;8760;4109;24;1126;4691;485;3533;0;2017;2121;HOSPITAL GENERAL DE AGUDOS DONACION F. SANTOJANNI;
Pediatria;Subtotal Pediatria;3346;332;3678;3312;22;3334;330;3664;41610;18997;114;5205;4565;518;3214;6;2017;2121;HOSPITAL GENERAL DE AGUDOS DONACION F. SANTOJANNI;
Tocoginecologia;Obstetricia;2708;0;2708;2701;0;2701;1;2702;21900;15304;60;4193;6988;566;4503;0;2017;2121;HOSPITAL GENERAL DE AGUDOS DONACION F. SANTOJANNI;
Tocoginecologia;Subtotal Tocoginecologia;2708;0;2708;2701;0;2701;1;2702;21900;15304;60;4193;6988;566;4503;0;2017;2121;HOSPITAL GENERAL DE AGUDOS DONACION F. SANTOJANNI;
Urgencia;Terapia Intermedia;8;16;24;7;2;9;17;26;2920;539;8;148;1846;2073;325;769;2017;2121;HOSPITAL GENERAL DE AGUDOS DONACION F. SANTOJANNI;
Urgencia;Terapia Intensiva;78;183;261;4;87;91;168;259;4380;2799;12;767;639;1081;2158;3359;2017;2121;HOSPITAL GENERAL DE AGUDOS DONACION F. SANTOJANNI;
Urgencia;Observación ;461;41;502;56;241;297;202;499;2920;2258;8;619;7733;453;6238;483;2017;2121;HOSPITAL GENERAL DE AGUDOS DONACION F. SANTOJANNI;
Urgencia;Subtotal Urgencia;547;240;787;67;330;397;387;784;10220;5596;28;1533;5476;714;28;4209;2017;2121;HOSPITAL GENERAL DE AGUDOS DONACION F. SANTOJANNI;
Urgencia;Total Hospital;11725;1500;13225;11056;637;11693;1500;13193;139430;94099;382;25781;6749;805;3061;545;2017;2121;HOSPITAL GENERAL DE AGUDOS DONACION F. SANTOJANNI;
Medicina;Cuidados Paliativos;93;49;142;64;77;141;1;142;1462;1345;401;368;92;947;3545;5423;2017;2124;HOSPITAL GENERAL DE AGUDOS DR. E. TORNU;
Medicina;Clínica Médica;74;725;799;564;88;652;138;790;15667;14266;4292;3908;9106;1806;184;1114;2017;2124;HOSPITAL GENERAL DE AGUDOS DR. E. TORNU;
Medicina;Neumotisiología;54;273;327;210;35;245;79;324;11238;3429;3079;939;3051;1058;1052;108;2017;2124;HOSPITAL GENERAL DE AGUDOS DR. E. TORNU;
Medicina;Subtotal Medicina;221;1047;1268;838;200;1038;218;1256;28367;19040;7772;5216;6712;1516;1616;1592;2017;2124;HOSPITAL GENERAL DE AGUDOS DR. E. TORNU;
Cirugia;Cirugía General;522;334;856;800;8;808;52;860;8734;4441;2393;1217;5085;516;3594;93;2017;2124;HOSPITAL GENERAL DE AGUDOS DR. E. TORNU;
Cirugia;Cirugía Toracica;47;53;100;74;0;74;26;100;2189;608;6;167;2778;608;1667;0;2017;2124;HOSPITAL GENERAL DE AGUDOS DR. E. TORNU;
Cirugia;Ginecología;203;8;211;209;0;209;2;211;535;535;147;147;100;254;14395;0;2017;2124;HOSPITAL GENERAL DE AGUDOS DR. E. TORNU;
Cirugia;Ortopedia Y Traumatología;70;108;178;166;4;170;11;181;4383;2388;1201;654;5448;1319;1507;221;2017;2124;HOSPITAL GENERAL DE AGUDOS DR. E. TORNU;
Cirugia;Urología;222;36;258;247;0;247;10;257;949;949;26;26;100;369;9885;0;2017;2124;HOSPITAL GENERAL DE AGUDOS DR. E. TORNU;
Cirugia;Subtotal Cirugia;1064;539;1603;1496;12;1508;101;1609;16790;8921;46;2444;5313;554;3498;75;2017;2124;HOSPITAL GENERAL DE AGUDOS DR. E. TORNU;
Urgencia;Terapia Intermedia;5;197;202;73;34;107;92;199;2944;2860;807;784;9715;1437;2467;1709;2017;2124;HOSPITAL GENERAL DE AGUDOS DR. E. TORNU;
Urgencia;Guardia Del Día;2730;35;2765;1160;107;1267;1498;2765;2608;2857;715;783;10955;103;38697;387;2017;2124;HOSPITAL GENERAL DE AGUDOS DR. E. TORNU;
Urgencia;Terapia Intensiva;3;211;214;8;85;93;120;213;2962;2789;812;764;9416;1309;2625;3991;2017;2124;HOSPITAL GENERAL DE AGUDOS DR. E. TORNU;
Cirugia;Subtotal Cirugia;4568;442;5010;4480;18;4498;505;5003;43562;22333;11935;6119;5127;446;4192;36;2017;2164;HOSPITAL GENERAL DE NIÑOS RICARDO GUTIERREZ;
Urgencia;Terapia Intermedia;80;445;525;43;2;45;476;521;2728;2298;747;63;8424;441;6971;38;2017;2164;HOSPITAL GENERAL DE NIÑOS RICARDO GUTIERREZ;
Urgencia;Terapia Intensiva;99;205;304;2;33;35;265;300;6258;4675;1715;1281;747;1558;175;11;2017;2164;HOSPITAL GENERAL DE NIÑOS RICARDO GUTIERREZ;
Urgencia;Subtotal Urgencia;179;650;829;45;35;80;741;821;8986;6973;2462;191;776;849;3335;426;2017;2164;HOSPITAL GENERAL DE NIÑOS RICARDO GUTIERREZ;
Urgencia;Total Hospital;9238;1991;11229;9117;80;9197;1991;11188;114476;78690;31363;21559;6874;856;2932;87;2017;2164;HOSPITAL GENERAL DE NIÑOS RICARDO GUTIERREZ;
Pediatria;Recien Nacido Sano;4738;448;5186;4710;0;4710;481;5191;25145;14812;6889;4058;5891;285;7535;0;2017;2167;HOSPITAL MATERNO INFANTIL R. SARDA;
Pediatria;Neonatología;1100;926;2026;1055;66;1121;893;2014;29565;14847;81;4068;5022;737;2486;328;2017;2167;HOSPITAL MATERNO INFANTIL R. SARDA;
Pediatria;Subtotal Pediatria;5838;1374;7212;5765;66;5831;1374;7205;54710;29659;14989;8126;5421;412;4807;92;2017;2167;HOSPITAL MATERNO INFANTIL R. SARDA;
Tocoginecologia;Tocoginecología;7012;175;7187;7046;0;7046;131;7177;35249;27917;9657;7648;792;389;7432;0;2017;2167;HOSPITAL MATERNO INFANTIL R. SARDA;
Tocoginecologia;Subtotal Tocoginecologia;7012;175;7187;7046;0;7046;131;7177;35249;27917;9657;7648;792;389;7432;0;2017;2167;HOSPITAL MATERNO INFANTIL R. SARDA;
Urgencia;Terapia Intensiva;47;28;75;3;0;3;72;75;731;311;2;85;4254;415;3745;0;2017;2167;HOSPITAL MATERNO INFANTIL R. SARDA;
Urgencia;Subtotal Urgencia;47;28;75;3;0;3;72;75;731;311;2;85;4254;415;3745;0;2017;2167;HOSPITAL MATERNO INFANTIL R. SARDA;
Urgencia;Total Hospital;12897;1577;14474;12814;66;12880;1577;14457;90690;57887;24847;15859;6383;449;5184;51;2017;2167;HOSPITAL MATERNO INFANTIL R. SARDA;
Medicina;Dermatología;376;11;387;310;0;310;72;382;12257;7659;3358;2098;6249;2005;1138;0;2017;2110;HOSPITAL DE INFECCIOSAS F. MUÑIZ;
Medicina;Infecciosas;1452;298;1750;1406;77;1483;263;1746;45432;29249;12447;8013;6438;1675;1403;441;2017;2110;HOSPITAL DE INFECCIOSAS F. MUÑIZ;
Medicina;Hepatopatía;115;34;149;108;23;131;20;151;4078;1996;1117;547;4895;1322;1352;1523;2017;2110;HOSPITAL DE INFECCIOSAS F. MUÑIZ;
Medicina;Neumotisiología;669;98;767;633;19;652;111;763;27479;15245;7528;4177;5548;1998;1013;249;2017;2110;HOSPITAL DE INFECCIOSAS F. MUÑIZ;
Medicina;Asistencia Respiratoria Intermedia;150;299;449;71;69;140;309;449;5000;2885;137;79;577;643;3278;1537;2017;2110;HOSPITAL DE INFECCIOSAS F. MUÑIZ;
Medicina;Zoopatología Médica;258;68;326;268;3;271;60;331;6525;3827;1788;1048;5865;1156;1852;91;2017;2110;HOSPITAL DE INFECCIOSAS F. MUÑIZ;
Medicina;Subtotal Medicina;3020;808;3828;2796;191;2987;835;3822;100771;60861;27608;16674;604;1592;1384;5;2017;2110;HOSPITAL DE INFECCIOSAS F. MUÑIZ;
Cirugia;Cirugía General;552;114;666;566;16;582;91;673;10275;3456;2815;947;3364;514;2391;238;2017;2110;HOSPITAL DE INFECCIOSAS F. MUÑIZ;
Cirugia;Subtotal Cirugia;552;114;666;566;16;582;91;673;10275;3456;2815;947;3364;514;2391;238;2017;2110;HOSPITAL DE INFECCIOSAS F. MUÑIZ;
Pediatria;Infecciosas Pediatría;407;15;422;409;0;409;16;425;11007;4753;3016;1302;4318;1118;1409;0;2017;2110;HOSPITAL DE INFECCIOSAS F. MUÑIZ;
Pediatria;Subtotal Pediatria;407;15;422;409;0;409;16;425;11007;4753;3016;1302;4318;1118;1409;0;2017;2110;HOSPITAL DE INFECCIOSAS F. MUÑIZ;
Urgencia;Terapia Intensiva;127;164;291;11;119;130;160;290;4307;2590;118;71;6013;893;2458;4103;2017;2110;HOSPITAL DE INFECCIOSAS F. MUÑIZ;
Urgencia;Observación ;13;29;42;7;6;13;28;41;477;231;131;63;4843;563;3137;1463;2017;2110;HOSPITAL DE INFECCIOSAS F. MUÑIZ;
Urgencia;Subtotal Urgencia;140;193;333;18;125;143;188;331;4784;2821;1311;773;5897;852;2525;3776;2017;2110;HOSPITAL DE INFECCIOSAS F. MUÑIZ;
Urgencia;Total Hospital;4119;1130;5249;3789;332;4121;1130;5251;126837;71891;3475;19696;5668;1745;1186;806;2017;2110;HOSPITAL DE INFECCIOSAS F. MUÑIZ;
Medicina;Curieterapia;33;3;36;31;0;31;3;34;999;139;274;38;1391;409;1242;0;2017;2168;HOSPITAL MUNICIPAL DE ONCOLOGIA MARIE CURIE;
Medicina;Medicina;1658;19;1677;1268;367;1635;47;1682;17209;15394;4715;4218;8945;915;3567;2182;2017;2168;HOSPITAL MUNICIPAL DE ONCOLOGIA MARIE CURIE;
Medicina;Subtotal Medicina;1691;22;1713;1299;367;1666;50;1716;18208;15533;4988;4256;8531;905;344;2139;2017;2168;HOSPITAL MUNICIPAL DE ONCOLOGIA MARIE CURIE;
Cirugia;Cirugía General;818;44;862;825;19;844;16;860;8767;3778;2402;1035;4309;439;358;221;2017;2168;HOSPITAL MUNICIPAL DE ONCOLOGIA MARIE CURIE;
Cirugia;Subtotal Cirugia;818;44;862;825;19;844;16;860;8767;3778;2402;1035;4309;439;358;221;2017;2168;HOSPITAL MUNICIPAL DE ONCOLOGIA MARIE CURIE;
Cirugia;Total Hospital;2509;66;2575;2124;386;2510;66;2576;26975;19311;739;5291;7159;769;3396;1538;2017;2168;HOSPITAL MUNICIPAL DE ONCOLOGIA MARIE CURIE;
Cirugia;Cirugía Plástica;683;4;687;680;0;680;7;687;2921;866;8;237;2965;126;8585;0;2017;2112;HOSPITAL DE QUEMADOS DR. ARTURO UMBERTO ILLIA;
Cirugia;Quemados ;13;158;171;97;3;100;71;171;3645;3261;999;893;8947;1907;1712;175;2017;2112;HOSPITAL DE QUEMADOS DR. ARTURO UMBERTO ILLIA;
Cirugia;Quemados - Cuidados Generales - Adultos;54;187;241;209;0;209;31;240;5133;2975;1406;815;5796;124;1707;0;2017;2112;HOSPITAL DE QUEMADOS DR. ARTURO UMBERTO ILLIA;
Cirugia;Subtotal Cirugia;750;349;1099;986;3;989;109;1098;11699;7102;3205;1946;6071;647;3426;27;2017;2112;HOSPITAL DE QUEMADOS DR. ARTURO UMBERTO ILLIA;
Pediatria;Quemados ;40;258;298;85;0;85;214;299;3654;3158;1001;865;8643;1056;2987;0;2017;2112;HOSPITAL DE QUEMADOS DR. ARTURO UMBERTO ILLIA;
Pediatria;Quemados - Cuidados Generales - Pediatría;44;227;271;260;0;260;7;267;2920;2536;8;695;8685;95;3338;0;2017;2112;HOSPITAL DE QUEMADOS DR. ARTURO UMBERTO ILLIA;
Pediatria;Quemados - Cuidados Intemedios - Pediatría0;0;1;1;0;0;0;0;0;0;0;;;;;;;2017;2112;HOSPITAL DE QUEMADOS DR. ARTURO UMBERTO ILLIA;
Pediatria;Subtotal Pediatria;84;486;570;345;0;345;221;566;6574;5694;1801;156;8661;1006;3143;0;2017;2112;HOSPITAL DE QUEMADOS DR. ARTURO UMBERTO ILLIA;
Urgencia;Guardia;604;1;605;48;0;48;558;606;1095;163;3;45;1489;27;202;0;2017;2112;HOSPITAL DE QUEMADOS DR. ARTURO UMBERTO ILLIA;
Urgencia;Quemados Cuidados Intensivos - Adultos;0;69;69;3;24;27;44;71;2190;1509;6;413;689;2125;1183;338;2017;2112;HOSPITAL DE QUEMADOS DR. ARTURO UMBERTO ILLIA;
Urgencia;Terapia Intensiva;7;48;55;29;5;34;21;55;1832;1405;502;385;7669;2555;1096;909;2017;2112;HOSPITAL DE QUEMADOS DR. ARTURO UMBERTO ILLIA;
Urgencia;Subtotal Urgencia;611;118;729;80;29;109;623;732;5117;3077;1402;843;6013;42;5221;396;2017;2112;HOSPITAL DE QUEMADOS DR. ARTURO UMBERTO ILLIA;
Urgencia;Total Hospital;1445;953;2398;1411;32;1443;953;2396;23390;15873;6408;4349;6786;11;2252;222;2017;2112;HOSPITAL DE QUEMADOS DR. ARTURO UMBERTO ILLIA;
Medicina;Clínica Médica;904;116;1020;724;94;818;215;1033;14196;12697;3889;3479;8944;1229;2656;91;2017;2109;HOSPITAL DE GASTROENTEROLOGIA B. UDAONDO;
Medicina;Subtotal Medicina;904;116;1020;724;94;818;215;1033;14196;12697;3889;3479;8944;1229;2656;91;2017;2109;HOSPITAL DE GASTROENTEROLOGIA B. UDAONDO;
Cirugia;Cirugía;1021;344;1365;1178;13;1191;185;1376;12074;8451;3308;2315;6999;614;416;94;2017;2109;HOSPITAL DE GASTROENTEROLOGIA B. UDAONDO;
Cirugia;Subtotal Cirugia;1021;344;1365;1178;13;1191;185;1376;12074;8451;3308;2315;6999;614;416;94;2017;2109;HOSPITAL DE GASTROENTEROLOGIA B. UDAONDO;
Urgencia;Terapia Intensiva;119;169;288;7;46;53;229;282;2220;1892;608;518;8523;671;4636;1631;2017;2109;HOSPITAL DE GASTROENTEROLOGIA B. UDAONDO;
Urgencia;Subtotal Urgencia;119;169;288;7;46;53;229;282;2220;1892;608;518;8523;671;4636;1631;2017;2109;HOSPITAL DE GASTROENTEROLOGIA B. UDAONDO;
Urgencia;Total Hospital;2044;629;2673;1909;153;2062;629;2691;28490;23040;7805;6312;8087;1117;2642;742;2017;2109;HOSPITAL DE GASTROENTEROLOGIA B. UDAONDO;
Cirugia;Oftalmología;2630;0;2630;2627;0;2627;0;2627;8030;3092;22;847;3851;118;11941;0;2017;2169;HOSPITAL OFTALMOLOGICO DR. PEDRO LAGLEYZE;
Cirugia;Subtotal Cirugia;2630;0;2630;2627;0;2627;0;2627;8030;3092;22;847;3851;118;11941;0;2017;2169;HOSPITAL OFTALMOLOGICO DR. PEDRO LAGLEYZE;
Cirugia;Total Hospital;2630;0;2630;2627;0;2627;0;2627;8030;3092;22;847;3851;118;11941;0;2017;2169;HOSPITAL OFTALMOLOGICO DR. PEDRO LAGLEYZE;
Cirugia;Neurocirugía;39;34;73;37;0;37;35;72;2920;214;8;59;733;297;9;0;2017;2111;HOSPITAL DE OFTALMOLOGIA SANTA LUCIA;
Cirugia;Oftalmología;4293;0;4293;4315;0;4315;1;4316;10585;2640;29;723;2494;61;14883;0;2017;2111;HOSPITAL DE OFTALMOLOGIA SANTA LUCIA;
Cirugia;Subtotal Cirugia;4332;34;4366;4352;0;4352;36;4388;13505;2854;37;782;2113;65;11859;0;2017;2111;HOSPITAL DE OFTALMOLOGIA SANTA LUCIA;
Urgencia;Terapia Intensiva;1;35;36;3;0;3;33;36;1095;95;3;26;868;264;12;0;2017;2111;HOSPITAL DE OFTALMOLOGIA SANTA LUCIA;
Urgencia;Subtotal Urgencia;1;35;36;3;0;3;33;36;1095;95;3;26;868;264;12;0;2017;2111;HOSPITAL DE OFTALMOLOGIA SANTA LUCIA;
Urgencia;Total Hospital;4333;69;4402;4355;0;4355;69;4424;14600;2949;40;808;202;68;10888;0;2017;2111;HOSPITAL DE OFTALMOLOGIA SANTA LUCIA;
Medicina;Clínica Médica;0;214;214;52;1;53;161;214;11348;8311;3109;2277;7324;3884;688;47;2017;2117;HOSPITAL DE SALUD MENTAL J. T. BORDA;
Medicina;Psicopatologia Y Salud Mental;840;949;1789;789;4;793;1014;1807;236132;208214;64694;57045;8818;11523;279;22;2017;2117;HOSPITAL DE SALUD MENTAL J. T. BORDA;
Medicina;Subtotal Medicina;840;1163;2003;841;5;846;1175;2021;247480;216525;67803;59322;8749;10714;298;25;2017;2117;HOSPITAL DE SALUD MENTAL J. T. BORDA;
Cirugia;Cirugía General;0;51;51;7;0;7;39;46;3640;2247;997;616;6173;4885;461;0;2017;2117;HOSPITAL DE SALUD MENTAL J. T. BORDA;
Cirugia;Subtotal Cirugia;0;51;51;7;0;7;39;46;3640;2247;997;616;6173;4885;461;0;2017;2117;HOSPITAL DE SALUD MENTAL J. T. BORDA;
Cirugia;Total Hospital;840;1214;2054;848;5;853;1214;2067;251120;218772;688;59938;8712;25647;124;59;2017;2117;HOSPITAL DE SALUD MENTAL J. T. BORDA;
Medicina;Clínica Médica;0;22;22;7;3;10;12;22;9396;1448;2574;397;1541;6582;85;1364;2017;2116;HOSPITAL DE SALUD MENTAL BRAULIO MOYANO;
Medicina;Psicopatologia Y Salud Mental;949;817;1766;956;9;965;834;1799;306676;217513;84021;59593;7093;12091;214;5;2017;2116;HOSPITAL DE SALUD MENTAL BRAULIO MOYANO;
Medicina;Subtotal Medicina;949;839;1788;963;12;975;846;1821;316072;218961;86595;59989;6928;12024;21;66;2017;2116;HOSPITAL DE SALUD MENTAL BRAULIO MOYANO;
Cirugia;Cirugía General;0;21;21;3;0;3;16;19;5840;1301;16;356;2228;6847;119;0;2017;2116;HOSPITAL DE SALUD MENTAL BRAULIO MOYANO;
Cirugia;Ginecología;0;7;7;1;1;2;5;7;5840;351;16;96;601;5014;44;1429;2017;2116;HOSPITAL DE SALUD MENTAL BRAULIO MOYANO;
Cirugia;Subtotal Cirugia;0;28;28;4;1;5;21;26;11680;1652;32;453;1414;6354;81;385;2017;2116;HOSPITAL DE SALUD MENTAL BRAULIO MOYANO;
Cirugia;Total Hospital;949;867;1816;967;13;980;867;1847;327752;220613;89795;60442;6731;22512;109;133;2017;2116;HOSPITAL DE SALUD MENTAL BRAULIO MOYANO;
Pediatria;Psiquiatria;425;13;438;401;0;401;13;414;23360;13041;64;3573;5583;315;647;0;2017;2165;HOSPITAL INFANTO JUVENIL C. TOBAR GARCIA;
Pediatria;Subtotal Pediatria;425;13;438;401;0;401;13;414;23360;13041;64;3573;5583;315;647;0;2017;2165;HOSPITAL INFANTO JUVENIL C. TOBAR GARCIA;
Pediatria;Total Hospital;425;13;438;401;0;401;13;414;23360;13041;64;3573;5583;3252;627;0;2017;2165;HOSPITAL INFANTO JUVENIL C. TOBAR GARCIA;
Medicina;Psicopatologia Y Salud Mental;9;254;263;235;0;235;27;262;18260;17996;5003;493;9855;6869;524;0;2017;2108;HOSPITAL DE EMERGENCIAS PSIQUIATRICAS TORCUATO DE ALVEAR;
Medicina;Adolescencia;14;55;69;53;1;54;15;69;6705;4014;1837;11;5987;5817;376;145;2017;2108;HOSPITAL DE EMERGENCIAS PSIQUIATRICAS TORCUATO DE ALVEAR;
Medicina;Subtotal Medicina;23;309;332;288;1;289;42;331;24965;22010;684;603;8816;665;484;3;2017;2108;HOSPITAL DE EMERGENCIAS PSIQUIATRICAS TORCUATO DE ALVEAR;
Urgencia;Emergencia;385;36;421;118;0;118;303;421;6104;5501;1672;1507;9012;1307;2517;0;2017;2108;HOSPITAL DE EMERGENCIAS PSIQUIATRICAS TORCUATO DE ALVEAR;
Urgencia;Subtotal Urgencia;385;36;421;118;0;118;303;421;6104;5501;1672;1507;9012;1307;2517;0;2017;2108;HOSPITAL DE EMERGENCIAS PSIQUIATRICAS TORCUATO DE ALVEAR;
Urgencia;Total Hospital;408;345;753;406;1;407;345;752;31069;27511;8512;7537;8855;6759;478;25;2017;2108;HOSPITAL DE EMERGENCIAS PSIQUIATRICAS TORCUATO DE ALVEAR;
Medicina;Fisiatría;93;0;93;89;1;90;0;90;25815;21215;7073;5812;8218;23572;127;111;2017;2113;HOSPITAL DE REHABILITACION M. ROCCA;
Medicina;Subtotal Medicina;93;0;93;89;1;90;0;90;25815;21215;7073;5812;8218;23572;127;111;2017;2113;HOSPITAL DE REHABILITACION M. ROCCA;
Cirugia;Cirugía General;99;0;99;95;0;95;0;95;2168;896;594;245;4133;943;1599;0;2017;2113;HOSPITAL DE REHABILITACION M. ROCCA;
Cirugia;Subtotal Cirugia;99;0;99;95;0;95;0;95;2168;896;594;245;4133;943;1599;0;2017;2113;HOSPITAL DE REHABILITACION M. ROCCA;
Cirugia;Total Hospital;192;0;192;184;1;185;0;185;27983;22111;7667;6058;7902;11952;241;54;2017;2113;HOSPITAL DE REHABILITACION M. ROCCA;
Medicina;Fisiatría;93;7;100;87;0;87;3;90;16124;10003;4418;2741;6204;11114;204;0;2017;2114;INSTITUTO DE REHABILITACION PSICOFISICA (I.R.E.P.);
Medicina;Subtotal Medicina;93;7;100;87;0;87;3;90;16124;10003;4418;2741;6204;11114;204;0;2017;2114;INSTITUTO DE REHABILITACION PSICOFISICA (I.R.E.P.);
Cirugia;Cirugía General;417;37;454;416;1;417;41;458;9638;3689;2641;1011;3828;805;1734;22;2017;2114;INSTITUTO DE REHABILITACION PSICOFISICA (I.R.E.P.);
Cirugia;Subtotal Cirugia;417;37;454;416;1;417;41;458;9638;3689;2641;1011;3828;805;1734;22;2017;2114;INSTITUTO DE REHABILITACION PSICOFISICA (I.R.E.P.);
Cirugia;Total Hospital;510;44;554;503;1;504;44;548;25762;13692;7058;3751;5315;2717;714;2;2017;2114;INSTITUTO DE REHABILITACION PSICOFISICA (I.R.E.P.);
Medicina;Terapia Prolongada;622;197;819;761;18;779;38;817;3703;3083;1015;845;8326;377;8053;22;2017;2115;HOSPITAL DE REHABILITACION RESPIRATORIA MARIA FERRER;
Medicina;Terapia Intermedia;8;5;13;16;1;17;8;25;157;111;43;3;707;444;5812;4;2017;2115;HOSPITAL DE REHABILITACION RESPIRATORIA MARIA FERRER;
Medicina;Subtotal Medicina;630;202;832;777;19;796;46;842;3860;3194;1058;875;8275;379;7962;226;2017;2115;HOSPITAL DE REHABILITACION RESPIRATORIA MARIA FERRER;
Urgencia;Terapia Intensiva;283;38;321;97;31;128;194;322;2793;2125;765;582;7608;66;4208;963;2017;2115;HOSPITAL DE REHABILITACION RESPIRATORIA MARIA FERRER;
Urgencia;Subtotal Urgencia;283;38;321;97;31;128;194;322;2793;2125;765;582;7608;66;4208;963;2017;2115;HOSPITAL DE REHABILITACION RESPIRATORIA MARIA FERRER;
Urgencia;Total Hospital;913;240;1153;874;50;924;240;1164;6653;5319;1823;1457;7995;576;5069;541;2017;2115;HOSPITAL DE REHABILITACION RESPIRATORIA MARIA FERRER;
Medicina;Cardiología;0;130;130;110;1;111;19;130;1730;598;4;1;34;4;27;0;2011;2125;HOSPITAL GENERAL DE AGUDOS DR. I. PIROVANO;
Urgencia;Terapia Intermedia;2;0;2;0;0;0;2;2;6;;0;0;13;3;16;0;2011;2120;HOSPITAL GENERAL DE AGUDOS D. VELEZ SARSFIELD;
Medicina;Clínica Médica;0;142;142;27;13;40;68;108;11680;9867;32;27;84;91;3;12;2011;2117;HOSPITAL DE SALUD MENTAL J. T. BORDA;
Medicina;Neurología;0;8;8;2;0;2;18;20;5110;3431;14;9;67;171;1;0;2011;2117;HOSPITAL DE SALUD MENTAL J. T. BORDA;
Cirugia;Cirugía General;0;30;30;3;1;4;20;24;3650;2707;10;7;74;112;2;4;2011;2117;HOSPITAL DE SALUD MENTAL J. T. BORDA;
Cirugia;Subtotal Cirugia;0;30;30;3;1;4;20;24;3650;2707;10;7;74;112;2;4;2011;2117;HOSPITAL DE SALUD MENTAL J. T. BORDA;
Cirugia;Cirugía General;0;63;63;12;2;14;50;64;5840;4746;16;13;81;74;4;3;2011;2116;HOSPITAL DE SALUD MENTAL BRAULIO MOYANO;
Cirugia;Ginecología;0;12;12;4;1;5;8;13;5840;201;16;0;3;15;0;7;2011;2116;HOSPITAL DE SALUD MENTAL BRAULIO MOYANO;
Cirugia;Subtotal Cirugia;0;75;75;16;3;19;58;77;11680;4947;32;13;42;64;2;3;2011;2116;HOSPITAL DE SALUD MENTAL BRAULIO MOYANO;
Urgencia;Guardia Del Día;3070;0;3070;1222;141;1363;1694;3057;6250;6252;17;17;100;2;179;4;2012;2161;HOSPITAL GENERAL DE AGUDOS J. A. PENNA;
Tocoginecologia;Subtotal Tocoginecologia;1838;5;1843;1842;0;1842;10;1852;8790;6080;24;16;69;3;77;0;2012;2120;HOSPITAL GENERAL DE AGUDOS D. VELEZ SARSFIELD;
Urgencia;Terapia Intermedia;2;0;2;0;0;0;2;2;44;6;0;0;13;3;16;0;2011;2120;HOSPITAL GENERAL DE AGUDOS D. VELEZ SARSFIELD;
Pediatria;Recien Nacido Sano;2494;0;2494;2171;0;2171;326;2497;9577;7515;26;20;78;3;95;0;2012;2163;HOSPITAL GENERAL DE AGUDOS P. PIÑERO;
